"filename", "language", "JavaScript", "TypeScript JSX", "JSON", "CSS", "TypeScript", "comment", "blank", "total"
"c:\Users\rfrjo\pothole-detection-website\.next\app-build-manifest.json", "JSON", 0, 0, -10, 0, 0, 0, 0, -10
"c:\Users\rfrjo\pothole-detection-website\.next\server\_error.js", "JavaScript", -34, 0, 0, 0, 0, -24, -18, -76
"c:\Users\rfrjo\pothole-detection-website\.next\server\app-paths-manifest.json", "JSON", 0, 0, -1, 0, 0, 0, 0, -1
"c:\Users\rfrjo\pothole-detection-website\.next\server\app\_not-found\page.js", "JavaScript", 75, 0, 0, 0, 0, 45, 45, 165
"c:\Users\rfrjo\pothole-detection-website\.next\server\app\api\auth\[auth0]\route.js", "JavaScript", -90, 0, 0, 0, 0, -66, -60, -216
"c:\Users\rfrjo\pothole-detection-website\.next\server\app\dashboard\page.js", "JavaScript", 75, 0, 0, 0, 0, 45, 45, 165
"c:\Users\rfrjo\pothole-detection-website\.next\server\app\detections\page.js", "JavaScript", 75, 0, 0, 0, 0, 45, 45, 165
"c:\Users\rfrjo\pothole-detection-website\.next\server\app\help\page.js", "JavaScript", 75, 0, 0, 0, 0, 45, 45, 165
"c:\Users\rfrjo\pothole-detection-website\.next\server\app\maps\page.js", "JavaScript", -237, 0, 0, 0, 0, -138, -138, -513
"c:\Users\rfrjo\pothole-detection-website\.next\server\app\maps\page_client-reference-manifest.js", "JavaScript", -1, 0, 0, 0, 0, 0, 0, -1
"c:\Users\rfrjo\pothole-detection-website\.next\server\app\model\page.js", "JavaScript", 75, 0, 0, 0, 0, 45, 45, 165
"c:\Users\rfrjo\pothole-detection-website\.next\server\app\page.js", "JavaScript", 75, 0, 0, 0, 0, 45, 45, 165
"c:\Users\rfrjo\pothole-detection-website\.next\server\app\signin\page.js", "JavaScript", 75, 0, 0, 0, 0, 45, 45, 165
"c:\Users\rfrjo\pothole-detection-website\.next\server\app\signup\page.js", "JavaScript", -227, 0, 0, 0, 0, -132, -132, -491
"c:\Users\rfrjo\pothole-detection-website\.next\server\app\signup\page_client-reference-manifest.js", "JavaScript", -1, 0, 0, 0, 0, 0, 0, -1
"c:\Users\rfrjo\pothole-detection-website\.next\server\app\spreadsheets\page.js", "JavaScript", 90, 0, 0, 0, 0, 54, 54, 198
"c:\Users\rfrjo\pothole-detection-website\.next\server\app\upload\page.js", "JavaScript", 85, 0, 0, 0, 0, 51, 51, 187
"c:\Users\rfrjo\pothole-detection-website\.next\server\pages\_app.js", "JavaScript", -22, 0, 0, 0, 0, -15, -9, -46
"c:\Users\rfrjo\pothole-detection-website\.next\server\pages\_document.js", "JavaScript", -30, 0, 0, 0, 0, -21, -15, -66
"c:\Users\rfrjo\pothole-detection-website\.next\server\pages\_error.js", "JavaScript", -34, 0, 0, 0, 0, -24, -18, -76
"c:\Users\rfrjo\pothole-detection-website\.next\server\vendor-chunks\@auth0.js", "JavaScript", -27, 0, 0, 0, 0, -25, -17, -69
"c:\Users\rfrjo\pothole-detection-website\.next\server\vendor-chunks\@firebase.js", "JavaScript", 8, 0, 0, 0, 0, 6, 6, 20
"c:\Users\rfrjo\pothole-detection-website\.next\server\vendor-chunks\@hapi.js", "JavaScript", -62, 0, 0, 0, 0, -50, -43, -155
"c:\Users\rfrjo\pothole-detection-website\.next\server\vendor-chunks\@neondatabase.js", "JavaScript", -10, 0, 0, 0, 0, -11, -4, -25
"c:\Users\rfrjo\pothole-detection-website\.next\server\vendor-chunks\@panva.js", "JavaScript", -18, 0, 0, 0, 0, -17, -10, -45
"c:\Users\rfrjo\pothole-detection-website\.next\server\vendor-chunks\@radix-ui.js", "JavaScript", 16, 0, 0, 0, 0, 12, 12, 40
"c:\Users\rfrjo\pothole-detection-website\.next\server\vendor-chunks\@sideway.js", "JavaScript", -38, 0, 0, 0, 0, -32, -25, -95
"c:\Users\rfrjo\pothole-detection-website\.next\server\vendor-chunks\@vercel.js", "JavaScript", -14, 0, 0, 0, 0, -14, -7, -35
"c:\Users\rfrjo\pothole-detection-website\.next\server\vendor-chunks\bufferutil.js", "JavaScript", -14, 0, 0, 0, 0, -14, -7, -35
"c:\Users\rfrjo\pothole-detection-website\.next\server\vendor-chunks\cookie.js", "JavaScript", -10, 0, 0, 0, 0, -11, -4, -25
"c:\Users\rfrjo\pothole-detection-website\.next\server\vendor-chunks\debug.js", "JavaScript", -21, 0, 0, 0, 0, -20, -13, -54
"c:\Users\rfrjo\pothole-detection-website\.next\server\vendor-chunks\exif-js.js", "JavaScript", 9, 0, 0, 0, 0, 11, 4, 24
"c:\Users\rfrjo\pothole-detection-website\.next\server\vendor-chunks\firebase.js", "JavaScript", 4, 0, 0, 0, 0, 3, 3, 10
"c:\Users\rfrjo\pothole-detection-website\.next\server\vendor-chunks\goober.js", "JavaScript", -10, 0, 0, 0, 0, -11, -4, -25
"c:\Users\rfrjo\pothole-detection-website\.next\server\vendor-chunks\has-flag.js", "JavaScript", -10, 0, 0, 0, 0, -11, -4, -25
"c:\Users\rfrjo\pothole-detection-website\.next\server\vendor-chunks\joi.js", "JavaScript", -134, 0, 0, 0, 0, -104, -97, -335
"c:\Users\rfrjo\pothole-detection-website\.next\server\vendor-chunks\jose.js", "JavaScript", -342, 0, 0, 0, 0, -260, -253, -855
"c:\Users\rfrjo\pothole-detection-website\.next\server\vendor-chunks\lru-cache.js", "JavaScript", -10, 0, 0, 0, 0, -11, -4, -25
"c:\Users\rfrjo\pothole-detection-website\.next\server\vendor-chunks\lucide-react.js", "JavaScript", 4, 0, 0, 0, 0, 3, 3, 10
"c:\Users\rfrjo\pothole-detection-website\.next\server\vendor-chunks\ms.js", "JavaScript", -9, 0, 0, 0, 0, -11, -4, -24
"c:\Users\rfrjo\pothole-detection-website\.next\server\vendor-chunks\node-gyp-build.js", "JavaScript", -13, 0, 0, 0, 0, -14, -7, -34
"c:\Users\rfrjo\pothole-detection-website\.next\server\vendor-chunks\oidc-token-hash.js", "JavaScript", -13, 0, 0, 0, 0, -14, -7, -34
"c:\Users\rfrjo\pothole-detection-website\.next\server\vendor-chunks\openid-client.js", "JavaScript", -128, 0, 0, 0, 0, -98, -91, -317
"c:\Users\rfrjo\pothole-detection-website\.next\server\vendor-chunks\react-hot-toast.js", "JavaScript", -10, 0, 0, 0, 0, -11, -4, -25
"c:\Users\rfrjo\pothole-detection-website\.next\server\vendor-chunks\supports-color.js", "JavaScript", -10, 0, 0, 0, 0, -11, -4, -25
"c:\Users\rfrjo\pothole-detection-website\.next\server\vendor-chunks\url-join.js", "JavaScript", -9, 0, 0, 0, 0, -11, -4, -24
"c:\Users\rfrjo\pothole-detection-website\.next\server\vendor-chunks\ws.js", "JavaScript", -62, 0, 0, 0, 0, -50, -43, -155
"c:\Users\rfrjo\pothole-detection-website\.next\server\vendor-chunks\yallist.js", "JavaScript", -14, 0, 0, 0, 0, -14, -7, -35
"c:\Users\rfrjo\pothole-detection-website\.next\static\chunks\_error.js", "JavaScript", -13, 0, 0, 0, 0, -11, -4, -28
"c:\Users\rfrjo\pothole-detection-website\.next\static\chunks\app\dashboard\page.js", "JavaScript", 34, 0, 0, 0, 0, 21, 21, 76
"c:\Users\rfrjo\pothole-detection-website\.next\static\chunks\app\layout.js", "JavaScript", 34, 0, 0, 0, 0, 21, 21, 76
"c:\Users\rfrjo\pothole-detection-website\.next\static\chunks\app\maps\page.js", "JavaScript", -538, 0, 0, 0, 0, -326, -319, -1183
"c:\Users\rfrjo\pothole-detection-website\.next\static\chunks\app\page.js", "JavaScript", 39, 0, 0, 0, 0, 24, 24, 87
"c:\Users\rfrjo\pothole-detection-website\.next\static\chunks\app\signin\page.js", "JavaScript", 34, 0, 0, 0, 0, 21, 21, 76
"c:\Users\rfrjo\pothole-detection-website\.next\static\chunks\app\signup\page.js", "JavaScript", -317, 0, 0, 0, 0, -194, -187, -698
"c:\Users\rfrjo\pothole-detection-website\.next\static\chunks\app\spreadsheets\page.js", "JavaScript", 168, 0, 0, 0, 0, 102, 102, 372
"c:\Users\rfrjo\pothole-detection-website\.next\static\chunks\app\upload\page.js", "JavaScript", 68, 0, 0, 0, 0, 42, 42, 152
"c:\Users\rfrjo\pothole-detection-website\.next\static\chunks\fallback\amp.js", "JavaScript", -546, 0, 0, 0, 0, -333, -325, -1204
"c:\Users\rfrjo\pothole-detection-website\.next\static\chunks\fallback\main.js", "JavaScript", -1045, 0, 0, 0, 0, -636, -628, -2309
"c:\Users\rfrjo\pothole-detection-website\.next\static\chunks\fallback\pages\_app.js", "JavaScript", -13, 0, 0, 0, 0, -11, -4, -28
"c:\Users\rfrjo\pothole-detection-website\.next\static\chunks\fallback\pages\_error.js", "JavaScript", -13, 0, 0, 0, 0, -11, -4, -28
"c:\Users\rfrjo\pothole-detection-website\.next\static\chunks\fallback\react-refresh.js", "JavaScript", -28, 0, 0, 0, 0, -21, -13, -62
"c:\Users\rfrjo\pothole-detection-website\.next\static\chunks\fallback\webpack.js", "JavaScript", -1106, 0, 0, 0, 0, -112, 0, -1218
"c:\Users\rfrjo\pothole-detection-website\.next\static\chunks\main.js", "JavaScript", -1045, 0, 0, 0, 0, -636, -628, -2309
"c:\Users\rfrjo\pothole-detection-website\.next\static\chunks\pages\_app.js", "JavaScript", -13, 0, 0, 0, 0, -11, -4, -28
"c:\Users\rfrjo\pothole-detection-website\.next\static\chunks\pages\_error.js", "JavaScript", -13, 0, 0, 0, 0, -11, -4, -28
"c:\Users\rfrjo\pothole-detection-website\.next\static\chunks\react-refresh.js", "JavaScript", -28, 0, 0, 0, 0, -21, -13, -62
"c:\Users\rfrjo\pothole-detection-website\.next\static\css\app\layout.css", "CSS", 0, 0, 0, -33, 0, 0, 10, -23
"c:\Users\rfrjo\pothole-detection-website\.next\static\webpack\03f416adaa618df1.webpack.hot-update.json", "JSON", 0, 0, 1, 0, 0, 0, 0, 1
"c:\Users\rfrjo\pothole-detection-website\.next\static\webpack\052f6dea2efbf9c3.webpack.hot-update.json", "JSON", 0, 0, 1, 0, 0, 0, 0, 1
"c:\Users\rfrjo\pothole-detection-website\.next\static\webpack\05715a168cba21da.webpack.hot-update.json", "JSON", 0, 0, 1, 0, 0, 0, 0, 1
"c:\Users\rfrjo\pothole-detection-website\.next\static\webpack\08e6a1720712c1de.webpack.hot-update.json", "JSON", 0, 0, -1, 0, 0, 0, 0, -1
"c:\Users\rfrjo\pothole-detection-website\.next\static\webpack\09f2854a07611b91.webpack.hot-update.json", "JSON", 0, 0, 1, 0, 0, 0, 0, 1
"c:\Users\rfrjo\pothole-detection-website\.next\static\webpack\0e556f7ecf57b136.webpack.hot-update.json", "JSON", 0, 0, -1, 0, 0, 0, 0, -1
"c:\Users\rfrjo\pothole-detection-website\.next\static\webpack\0ef0af934fc2b140.webpack.hot-update.json", "JSON", 0, 0, -1, 0, 0, 0, 0, -1
"c:\Users\rfrjo\pothole-detection-website\.next\static\webpack\0f59587d0a6f5dd0.webpack.hot-update.json", "JSON", 0, 0, 1, 0, 0, 0, 0, 1
"c:\Users\rfrjo\pothole-detection-website\.next\static\webpack\1019e17dc34f90f7.webpack.hot-update.json", "JSON", 0, 0, -1, 0, 0, 0, 0, -1
"c:\Users\rfrjo\pothole-detection-website\.next\static\webpack\10d06a07761b1004.webpack.hot-update.json", "JSON", 0, 0, -1, 0, 0, 0, 0, -1
"c:\Users\rfrjo\pothole-detection-website\.next\static\webpack\10f36f7c29af944b.webpack.hot-update.json", "JSON", 0, 0, -1, 0, 0, 0, 0, -1
"c:\Users\rfrjo\pothole-detection-website\.next\static\webpack\11f5b055fd4bd836.webpack.hot-update.json", "JSON", 0, 0, -1, 0, 0, 0, 0, -1
"c:\Users\rfrjo\pothole-detection-website\.next\static\webpack\139d8656c3bb11a5.webpack.hot-update.json", "JSON", 0, 0, -1, 0, 0, 0, 0, -1
"c:\Users\rfrjo\pothole-detection-website\.next\static\webpack\14f23adcc8b61558.webpack.hot-update.json", "JSON", 0, 0, -1, 0, 0, 0, 0, -1
"c:\Users\rfrjo\pothole-detection-website\.next\static\webpack\15118643dcb53d1a.webpack.hot-update.json", "JSON", 0, 0, -1, 0, 0, 0, 0, -1
"c:\Users\rfrjo\pothole-detection-website\.next\static\webpack\15533c9ad4427e70.webpack.hot-update.json", "JSON", 0, 0, -1, 0, 0, 0, 0, -1
"c:\Users\rfrjo\pothole-detection-website\.next\static\webpack\16a32586d354b631.webpack.hot-update.json", "JSON", 0, 0, 1, 0, 0, 0, 0, 1
"c:\Users\rfrjo\pothole-detection-website\.next\static\webpack\1b6b2212351d04eb.webpack.hot-update.json", "JSON", 0, 0, 1, 0, 0, 0, 0, 1
"c:\Users\rfrjo\pothole-detection-website\.next\static\webpack\1bf57e9ca108224a.webpack.hot-update.json", "JSON", 0, 0, 1, 0, 0, 0, 0, 1
"c:\Users\rfrjo\pothole-detection-website\.next\static\webpack\1c27704668b698fe.webpack.hot-update.json", "JSON", 0, 0, -1, 0, 0, 0, 0, -1
"c:\Users\rfrjo\pothole-detection-website\.next\static\webpack\1c32acae818838c2.webpack.hot-update.json", "JSON", 0, 0, -1, 0, 0, 0, 0, -1
"c:\Users\rfrjo\pothole-detection-website\.next\static\webpack\1d34ad3f0c956b35.webpack.hot-update.json", "JSON", 0, 0, 1, 0, 0, 0, 0, 1
"c:\Users\rfrjo\pothole-detection-website\.next\static\webpack\1d5788842318190b.webpack.hot-update.json", "JSON", 0, 0, 1, 0, 0, 0, 0, 1
"c:\Users\rfrjo\pothole-detection-website\.next\static\webpack\1e178d13d373339b.webpack.hot-update.json", "JSON", 0, 0, -1, 0, 0, 0, 0, -1
"c:\Users\rfrjo\pothole-detection-website\.next\static\webpack\1e3b0b7a7dabaae1.webpack.hot-update.json", "JSON", 0, 0, -1, 0, 0, 0, 0, -1
"c:\Users\rfrjo\pothole-detection-website\.next\static\webpack\1eaa88a0999b1364.webpack.hot-update.json", "JSON", 0, 0, -1, 0, 0, 0, 0, -1
"c:\Users\rfrjo\pothole-detection-website\.next\static\webpack\1f834d24ad74b4f6.webpack.hot-update.json", "JSON", 0, 0, 1, 0, 0, 0, 0, 1
"c:\Users\rfrjo\pothole-detection-website\.next\static\webpack\1f9d5f14b6b613da.webpack.hot-update.json", "JSON", 0, 0, -1, 0, 0, 0, 0, -1
"c:\Users\rfrjo\pothole-detection-website\.next\static\webpack\237a39fa8ef5c6e3.webpack.hot-update.json", "JSON", 0, 0, -1, 0, 0, 0, 0, -1
"c:\Users\rfrjo\pothole-detection-website\.next\static\webpack\23a5b02801af775d.webpack.hot-update.json", "JSON", 0, 0, -1, 0, 0, 0, 0, -1
"c:\Users\rfrjo\pothole-detection-website\.next\static\webpack\241e6549ff2bdfb9.webpack.hot-update.json", "JSON", 0, 0, 1, 0, 0, 0, 0, 1
"c:\Users\rfrjo\pothole-detection-website\.next\static\webpack\2437995ad6de6d44.webpack.hot-update.json", "JSON", 0, 0, 1, 0, 0, 0, 0, 1
"c:\Users\rfrjo\pothole-detection-website\.next\static\webpack\2447dcefc4d408c0.webpack.hot-update.json", "JSON", 0, 0, 1, 0, 0, 0, 0, 1
"c:\Users\rfrjo\pothole-detection-website\.next\static\webpack\2581eb8befa4fe57.webpack.hot-update.json", "JSON", 0, 0, -1, 0, 0, 0, 0, -1
"c:\Users\rfrjo\pothole-detection-website\.next\static\webpack\25e2634e463d29f1.webpack.hot-update.json", "JSON", 0, 0, -1, 0, 0, 0, 0, -1
"c:\Users\rfrjo\pothole-detection-website\.next\static\webpack\261582b8a4c03c81.webpack.hot-update.json", "JSON", 0, 0, 1, 0, 0, 0, 0, 1
"c:\Users\rfrjo\pothole-detection-website\.next\static\webpack\26b9be174d75f607.webpack.hot-update.json", "JSON", 0, 0, -1, 0, 0, 0, 0, -1
"c:\Users\rfrjo\pothole-detection-website\.next\static\webpack\27f6d42552c967a9.webpack.hot-update.json", "JSON", 0, 0, -1, 0, 0, 0, 0, -1
"c:\Users\rfrjo\pothole-detection-website\.next\static\webpack\2af20e4231425d85.webpack.hot-update.json", "JSON", 0, 0, 1, 0, 0, 0, 0, 1
"c:\Users\rfrjo\pothole-detection-website\.next\static\webpack\2bfff34f33985a5c.webpack.hot-update.json", "JSON", 0, 0, 1, 0, 0, 0, 0, 1
"c:\Users\rfrjo\pothole-detection-website\.next\static\webpack\2c8586f1d74b8d89.webpack.hot-update.json", "JSON", 0, 0, -1, 0, 0, 0, 0, -1
"c:\Users\rfrjo\pothole-detection-website\.next\static\webpack\2df75f17c78eeaf1.webpack.hot-update.json", "JSON", 0, 0, 1, 0, 0, 0, 0, 1
"c:\Users\rfrjo\pothole-detection-website\.next\static\webpack\2f8ca1b723b8efb7.webpack.hot-update.json", "JSON", 0, 0, -1, 0, 0, 0, 0, -1
"c:\Users\rfrjo\pothole-detection-website\.next\static\webpack\2f9f2a69e2e50e87.webpack.hot-update.json", "JSON", 0, 0, -1, 0, 0, 0, 0, -1
"c:\Users\rfrjo\pothole-detection-website\.next\static\webpack\3075e1cd05d6febe.webpack.hot-update.json", "JSON", 0, 0, -1, 0, 0, 0, 0, -1
"c:\Users\rfrjo\pothole-detection-website\.next\static\webpack\336c5b89b535e2de.webpack.hot-update.json", "JSON", 0, 0, 1, 0, 0, 0, 0, 1
"c:\Users\rfrjo\pothole-detection-website\.next\static\webpack\35543311e684b41b.webpack.hot-update.json", "JSON", 0, 0, -1, 0, 0, 0, 0, -1
"c:\Users\rfrjo\pothole-detection-website\.next\static\webpack\35bbf55acd2f0777.webpack.hot-update.json", "JSON", 0, 0, -1, 0, 0, 0, 0, -1
"c:\Users\rfrjo\pothole-detection-website\.next\static\webpack\36277ac7fedd49ae.webpack.hot-update.json", "JSON", 0, 0, -1, 0, 0, 0, 0, -1
"c:\Users\rfrjo\pothole-detection-website\.next\static\webpack\366f97835718ae55.webpack.hot-update.json", "JSON", 0, 0, -1, 0, 0, 0, 0, -1
"c:\Users\rfrjo\pothole-detection-website\.next\static\webpack\36ecf676eed32104.webpack.hot-update.json", "JSON", 0, 0, -1, 0, 0, 0, 0, -1
"c:\Users\rfrjo\pothole-detection-website\.next\static\webpack\3703bf15d620330d.webpack.hot-update.json", "JSON", 0, 0, -1, 0, 0, 0, 0, -1
"c:\Users\rfrjo\pothole-detection-website\.next\static\webpack\382141e07fdcde74.webpack.hot-update.json", "JSON", 0, 0, -1, 0, 0, 0, 0, -1
"c:\Users\rfrjo\pothole-detection-website\.next\static\webpack\38eee2056242a06d.webpack.hot-update.json", "JSON", 0, 0, -1, 0, 0, 0, 0, -1
"c:\Users\rfrjo\pothole-detection-website\.next\static\webpack\395562a4717d2f7f.webpack.hot-update.json", "JSON", 0, 0, 1, 0, 0, 0, 0, 1
"c:\Users\rfrjo\pothole-detection-website\.next\static\webpack\3af8302a34ff3f9b.webpack.hot-update.json", "JSON", 0, 0, 1, 0, 0, 0, 0, 1
"c:\Users\rfrjo\pothole-detection-website\.next\static\webpack\3c4b6483cb36fe68.webpack.hot-update.json", "JSON", 0, 0, -1, 0, 0, 0, 0, -1
"c:\Users\rfrjo\pothole-detection-website\.next\static\webpack\3ca36a23adbbd0d4.webpack.hot-update.json", "JSON", 0, 0, -1, 0, 0, 0, 0, -1
"c:\Users\rfrjo\pothole-detection-website\.next\static\webpack\3ceff98b83edd5ba.webpack.hot-update.json", "JSON", 0, 0, -1, 0, 0, 0, 0, -1
"c:\Users\rfrjo\pothole-detection-website\.next\static\webpack\3d3bada15a49a51a.webpack.hot-update.json", "JSON", 0, 0, 1, 0, 0, 0, 0, 1
"c:\Users\rfrjo\pothole-detection-website\.next\static\webpack\3f143ce00dddf463.webpack.hot-update.json", "JSON", 0, 0, -1, 0, 0, 0, 0, -1
"c:\Users\rfrjo\pothole-detection-website\.next\static\webpack\3fd574372d51d356.webpack.hot-update.json", "JSON", 0, 0, -1, 0, 0, 0, 0, -1
"c:\Users\rfrjo\pothole-detection-website\.next\static\webpack\40295ba76eb93afd.webpack.hot-update.json", "JSON", 0, 0, -1, 0, 0, 0, 0, -1
"c:\Users\rfrjo\pothole-detection-website\.next\static\webpack\404846168f14f227.webpack.hot-update.json", "JSON", 0, 0, -1, 0, 0, 0, 0, -1
"c:\Users\rfrjo\pothole-detection-website\.next\static\webpack\437e40c658bb17cd.webpack.hot-update.json", "JSON", 0, 0, -1, 0, 0, 0, 0, -1
"c:\Users\rfrjo\pothole-detection-website\.next\static\webpack\44288f0073fcc4b9.webpack.hot-update.json", "JSON", 0, 0, -1, 0, 0, 0, 0, -1
"c:\Users\rfrjo\pothole-detection-website\.next\static\webpack\47396008231a81e3.webpack.hot-update.json", "JSON", 0, 0, 1, 0, 0, 0, 0, 1
"c:\Users\rfrjo\pothole-detection-website\.next\static\webpack\478146370f32c537.webpack.hot-update.json", "JSON", 0, 0, -1, 0, 0, 0, 0, -1
"c:\Users\rfrjo\pothole-detection-website\.next\static\webpack\4936085bfb196153.webpack.hot-update.json", "JSON", 0, 0, -1, 0, 0, 0, 0, -1
"c:\Users\rfrjo\pothole-detection-website\.next\static\webpack\4973ea30c81c600a.webpack.hot-update.json", "JSON", 0, 0, -1, 0, 0, 0, 0, -1
"c:\Users\rfrjo\pothole-detection-website\.next\static\webpack\497efc25dbe6dd76.webpack.hot-update.json", "JSON", 0, 0, -1, 0, 0, 0, 0, -1
"c:\Users\rfrjo\pothole-detection-website\.next\static\webpack\499d0255c918291e.webpack.hot-update.json", "JSON", 0, 0, -1, 0, 0, 0, 0, -1
"c:\Users\rfrjo\pothole-detection-website\.next\static\webpack\4aadc740f0277373.webpack.hot-update.json", "JSON", 0, 0, -1, 0, 0, 0, 0, -1
"c:\Users\rfrjo\pothole-detection-website\.next\static\webpack\4acf9e39d300fd5c.webpack.hot-update.json", "JSON", 0, 0, -1, 0, 0, 0, 0, -1
"c:\Users\rfrjo\pothole-detection-website\.next\static\webpack\4b294efc754c21b7.webpack.hot-update.json", "JSON", 0, 0, -1, 0, 0, 0, 0, -1
"c:\Users\rfrjo\pothole-detection-website\.next\static\webpack\4bac7e0d3bc694aa.webpack.hot-update.json", "JSON", 0, 0, -1, 0, 0, 0, 0, -1
"c:\Users\rfrjo\pothole-detection-website\.next\static\webpack\4be6c3196b0e7880.webpack.hot-update.json", "JSON", 0, 0, 1, 0, 0, 0, 0, 1
"c:\Users\rfrjo\pothole-detection-website\.next\static\webpack\4cc9dfe53752ec11.webpack.hot-update.json", "JSON", 0, 0, 1, 0, 0, 0, 0, 1
"c:\Users\rfrjo\pothole-detection-website\.next\static\webpack\4df61bd6841d5eac.webpack.hot-update.json", "JSON", 0, 0, -1, 0, 0, 0, 0, -1
"c:\Users\rfrjo\pothole-detection-website\.next\static\webpack\4e4c07c1c572ae5f.webpack.hot-update.json", "JSON", 0, 0, 1, 0, 0, 0, 0, 1
"c:\Users\rfrjo\pothole-detection-website\.next\static\webpack\4e7177463858ed6a.webpack.hot-update.json", "JSON", 0, 0, 1, 0, 0, 0, 0, 1
"c:\Users\rfrjo\pothole-detection-website\.next\static\webpack\4ff81d283a481acd.webpack.hot-update.json", "JSON", 0, 0, -1, 0, 0, 0, 0, -1
"c:\Users\rfrjo\pothole-detection-website\.next\static\webpack\52a6ee1060dbb5bd.webpack.hot-update.json", "JSON", 0, 0, -1, 0, 0, 0, 0, -1
"c:\Users\rfrjo\pothole-detection-website\.next\static\webpack\536a639bf7e5e9f4.webpack.hot-update.json", "JSON", 0, 0, -1, 0, 0, 0, 0, -1
"c:\Users\rfrjo\pothole-detection-website\.next\static\webpack\53e51f86ef56df26.webpack.hot-update.json", "JSON", 0, 0, -1, 0, 0, 0, 0, -1
"c:\Users\rfrjo\pothole-detection-website\.next\static\webpack\54f6af229006dffa.webpack.hot-update.json", "JSON", 0, 0, -1, 0, 0, 0, 0, -1
"c:\Users\rfrjo\pothole-detection-website\.next\static\webpack\55c1de0576594fd6.webpack.hot-update.json", "JSON", 0, 0, -1, 0, 0, 0, 0, -1
"c:\Users\rfrjo\pothole-detection-website\.next\static\webpack\568a68dbfa67aef9.webpack.hot-update.json", "JSON", 0, 0, -1, 0, 0, 0, 0, -1
"c:\Users\rfrjo\pothole-detection-website\.next\static\webpack\599be672b367805b.webpack.hot-update.json", "JSON", 0, 0, 1, 0, 0, 0, 0, 1
"c:\Users\rfrjo\pothole-detection-website\.next\static\webpack\59bfc2d9eba83495.webpack.hot-update.json", "JSON", 0, 0, -1, 0, 0, 0, 0, -1
"c:\Users\rfrjo\pothole-detection-website\.next\static\webpack\59f4dd90ac1f2a7b.webpack.hot-update.json", "JSON", 0, 0, -1, 0, 0, 0, 0, -1
"c:\Users\rfrjo\pothole-detection-website\.next\static\webpack\5a3d1bcfab1dc770.webpack.hot-update.json", "JSON", 0, 0, -1, 0, 0, 0, 0, -1
"c:\Users\rfrjo\pothole-detection-website\.next\static\webpack\5ab59c38990547bb.webpack.hot-update.json", "JSON", 0, 0, -1, 0, 0, 0, 0, -1
"c:\Users\rfrjo\pothole-detection-website\.next\static\webpack\5b9b8e077d5bcc30.webpack.hot-update.json", "JSON", 0, 0, -1, 0, 0, 0, 0, -1
"c:\Users\rfrjo\pothole-detection-website\.next\static\webpack\5bbc0606b035f308.webpack.hot-update.json", "JSON", 0, 0, -1, 0, 0, 0, 0, -1
"c:\Users\rfrjo\pothole-detection-website\.next\static\webpack\5c91122845ef46d4.webpack.hot-update.json", "JSON", 0, 0, -1, 0, 0, 0, 0, -1
"c:\Users\rfrjo\pothole-detection-website\.next\static\webpack\5cabda8068dd9499.webpack.hot-update.json", "JSON", 0, 0, -1, 0, 0, 0, 0, -1
"c:\Users\rfrjo\pothole-detection-website\.next\static\webpack\5cf37d63cfe8d600.webpack.hot-update.json", "JSON", 0, 0, 1, 0, 0, 0, 0, 1
"c:\Users\rfrjo\pothole-detection-website\.next\static\webpack\5ea620540924ee60.webpack.hot-update.json", "JSON", 0, 0, -1, 0, 0, 0, 0, -1
"c:\Users\rfrjo\pothole-detection-website\.next\static\webpack\5ff81fa1db133655.webpack.hot-update.json", "JSON", 0, 0, -1, 0, 0, 0, 0, -1
"c:\Users\rfrjo\pothole-detection-website\.next\static\webpack\60527942db46d9b8.webpack.hot-update.json", "JSON", 0, 0, -1, 0, 0, 0, 0, -1
"c:\Users\rfrjo\pothole-detection-website\.next\static\webpack\6088ea14f533caf0.webpack.hot-update.json", "JSON", 0, 0, -1, 0, 0, 0, 0, -1
"c:\Users\rfrjo\pothole-detection-website\.next\static\webpack\611d7ddaf6eaaea5.webpack.hot-update.json", "JSON", 0, 0, 1, 0, 0, 0, 0, 1
"c:\Users\rfrjo\pothole-detection-website\.next\static\webpack\629b8911cc520362.webpack.hot-update.json", "JSON", 0, 0, -1, 0, 0, 0, 0, -1
"c:\Users\rfrjo\pothole-detection-website\.next\static\webpack\63971713ced1858f.webpack.hot-update.json", "JSON", 0, 0, -1, 0, 0, 0, 0, -1
"c:\Users\rfrjo\pothole-detection-website\.next\static\webpack\64ce06dd8784dad5.webpack.hot-update.json", "JSON", 0, 0, 1, 0, 0, 0, 0, 1
"c:\Users\rfrjo\pothole-detection-website\.next\static\webpack\6526ad0581466889.webpack.hot-update.json", "JSON", 0, 0, -1, 0, 0, 0, 0, -1
"c:\Users\rfrjo\pothole-detection-website\.next\static\webpack\6542ad685ec8b80d.webpack.hot-update.json", "JSON", 0, 0, -1, 0, 0, 0, 0, -1
"c:\Users\rfrjo\pothole-detection-website\.next\static\webpack\66d5ebd90917e4be.webpack.hot-update.json", "JSON", 0, 0, -1, 0, 0, 0, 0, -1
"c:\Users\rfrjo\pothole-detection-website\.next\static\webpack\6b3302e462d47832.webpack.hot-update.json", "JSON", 0, 0, 1, 0, 0, 0, 0, 1
"c:\Users\rfrjo\pothole-detection-website\.next\static\webpack\6c4c64dd3db346a4.webpack.hot-update.json", "JSON", 0, 0, -1, 0, 0, 0, 0, -1
"c:\Users\rfrjo\pothole-detection-website\.next\static\webpack\6e00b59ed9168a3b.webpack.hot-update.json", "JSON", 0, 0, -1, 0, 0, 0, 0, -1
"c:\Users\rfrjo\pothole-detection-website\.next\static\webpack\6e17eea08daa4461.webpack.hot-update.json", "JSON", 0, 0, 1, 0, 0, 0, 0, 1
"c:\Users\rfrjo\pothole-detection-website\.next\static\webpack\6f49d563ee97279e.webpack.hot-update.json", "JSON", 0, 0, -1, 0, 0, 0, 0, -1
"c:\Users\rfrjo\pothole-detection-website\.next\static\webpack\6f4e069acbdb7f44.webpack.hot-update.json", "JSON", 0, 0, -1, 0, 0, 0, 0, -1
"c:\Users\rfrjo\pothole-detection-website\.next\static\webpack\704ada73f32ffcfe.webpack.hot-update.json", "JSON", 0, 0, 1, 0, 0, 0, 0, 1
"c:\Users\rfrjo\pothole-detection-website\.next\static\webpack\705b809a0da72e0a.webpack.hot-update.json", "JSON", 0, 0, -1, 0, 0, 0, 0, -1
"c:\Users\rfrjo\pothole-detection-website\.next\static\webpack\7117d69c4d8dd1f0.webpack.hot-update.json", "JSON", 0, 0, -1, 0, 0, 0, 0, -1
"c:\Users\rfrjo\pothole-detection-website\.next\static\webpack\718317dae5cd0fbb.webpack.hot-update.json", "JSON", 0, 0, -1, 0, 0, 0, 0, -1
"c:\Users\rfrjo\pothole-detection-website\.next\static\webpack\71b4169a9c09d80b.webpack.hot-update.json", "JSON", 0, 0, -1, 0, 0, 0, 0, -1
"c:\Users\rfrjo\pothole-detection-website\.next\static\webpack\72539884909e2f51.webpack.hot-update.json", "JSON", 0, 0, -1, 0, 0, 0, 0, -1
"c:\Users\rfrjo\pothole-detection-website\.next\static\webpack\72e8be227edd0633.webpack.hot-update.json", "JSON", 0, 0, 1, 0, 0, 0, 0, 1
"c:\Users\rfrjo\pothole-detection-website\.next\static\webpack\74bf66b145b7f31a.webpack.hot-update.json", "JSON", 0, 0, 1, 0, 0, 0, 0, 1
"c:\Users\rfrjo\pothole-detection-website\.next\static\webpack\7553387ad1cc69a3.webpack.hot-update.json", "JSON", 0, 0, 1, 0, 0, 0, 0, 1
"c:\Users\rfrjo\pothole-detection-website\.next\static\webpack\76d95935b394a037.webpack.hot-update.json", "JSON", 0, 0, -1, 0, 0, 0, 0, -1
"c:\Users\rfrjo\pothole-detection-website\.next\static\webpack\771791e9f93ad77e.webpack.hot-update.json", "JSON", 0, 0, -1, 0, 0, 0, 0, -1
"c:\Users\rfrjo\pothole-detection-website\.next\static\webpack\7724e64c228ec499.webpack.hot-update.json", "JSON", 0, 0, -1, 0, 0, 0, 0, -1
"c:\Users\rfrjo\pothole-detection-website\.next\static\webpack\788ddaeb2bb2bb7b.webpack.hot-update.json", "JSON", 0, 0, -1, 0, 0, 0, 0, -1
"c:\Users\rfrjo\pothole-detection-website\.next\static\webpack\78b9918761b7ec60.webpack.hot-update.json", "JSON", 0, 0, -1, 0, 0, 0, 0, -1
"c:\Users\rfrjo\pothole-detection-website\.next\static\webpack\7c100b06603ce490.webpack.hot-update.json", "JSON", 0, 0, -1, 0, 0, 0, 0, -1
"c:\Users\rfrjo\pothole-detection-website\.next\static\webpack\7c3c6c0fb7269248.webpack.hot-update.json", "JSON", 0, 0, -1, 0, 0, 0, 0, -1
"c:\Users\rfrjo\pothole-detection-website\.next\static\webpack\7e20b43409008cc0.webpack.hot-update.json", "JSON", 0, 0, -1, 0, 0, 0, 0, -1
"c:\Users\rfrjo\pothole-detection-website\.next\static\webpack\80818ec3b62912ab.webpack.hot-update.json", "JSON", 0, 0, -1, 0, 0, 0, 0, -1
"c:\Users\rfrjo\pothole-detection-website\.next\static\webpack\813daabf623bf7ff.webpack.hot-update.json", "JSON", 0, 0, 1, 0, 0, 0, 0, 1
"c:\Users\rfrjo\pothole-detection-website\.next\static\webpack\82bcae466be0d753.webpack.hot-update.json", "JSON", 0, 0, 1, 0, 0, 0, 0, 1
"c:\Users\rfrjo\pothole-detection-website\.next\static\webpack\830fc07e3aa56e50.webpack.hot-update.json", "JSON", 0, 0, -1, 0, 0, 0, 0, -1
"c:\Users\rfrjo\pothole-detection-website\.next\static\webpack\836403eb24b7ffbd.webpack.hot-update.json", "JSON", 0, 0, -1, 0, 0, 0, 0, -1
"c:\Users\rfrjo\pothole-detection-website\.next\static\webpack\84b6aaa9e7aab2e2.webpack.hot-update.json", "JSON", 0, 0, -1, 0, 0, 0, 0, -1
"c:\Users\rfrjo\pothole-detection-website\.next\static\webpack\854534e54fe1e890.webpack.hot-update.json", "JSON", 0, 0, -1, 0, 0, 0, 0, -1
"c:\Users\rfrjo\pothole-detection-website\.next\static\webpack\863a15ead088bba9.webpack.hot-update.json", "JSON", 0, 0, -1, 0, 0, 0, 0, -1
"c:\Users\rfrjo\pothole-detection-website\.next\static\webpack\87eae4974001cebd.webpack.hot-update.json", "JSON", 0, 0, -1, 0, 0, 0, 0, -1
"c:\Users\rfrjo\pothole-detection-website\.next\static\webpack\8894e59acb5af99a.webpack.hot-update.json", "JSON", 0, 0, -1, 0, 0, 0, 0, -1
"c:\Users\rfrjo\pothole-detection-website\.next\static\webpack\89bd7cc19491664a.webpack.hot-update.json", "JSON", 0, 0, -1, 0, 0, 0, 0, -1
"c:\Users\rfrjo\pothole-detection-website\.next\static\webpack\89bf9314c5143b75.webpack.hot-update.json", "JSON", 0, 0, -1, 0, 0, 0, 0, -1
"c:\Users\rfrjo\pothole-detection-website\.next\static\webpack\8ce78540ee6b936c.webpack.hot-update.json", "JSON", 0, 0, 1, 0, 0, 0, 0, 1
"c:\Users\rfrjo\pothole-detection-website\.next\static\webpack\8cfc7e3849acd858.webpack.hot-update.json", "JSON", 0, 0, -1, 0, 0, 0, 0, -1
"c:\Users\rfrjo\pothole-detection-website\.next\static\webpack\8d1022a00db06c96.webpack.hot-update.json", "JSON", 0, 0, 1, 0, 0, 0, 0, 1
"c:\Users\rfrjo\pothole-detection-website\.next\static\webpack\8fd824ed7d27ab5d.webpack.hot-update.json", "JSON", 0, 0, -1, 0, 0, 0, 0, -1
"c:\Users\rfrjo\pothole-detection-website\.next\static\webpack\90045a25807a574e.webpack.hot-update.json", "JSON", 0, 0, -1, 0, 0, 0, 0, -1
"c:\Users\rfrjo\pothole-detection-website\.next\static\webpack\90600ccfb467a9cb.webpack.hot-update.json", "JSON", 0, 0, 1, 0, 0, 0, 0, 1
"c:\Users\rfrjo\pothole-detection-website\.next\static\webpack\9066f5ce9def0675.webpack.hot-update.json", "JSON", 0, 0, -1, 0, 0, 0, 0, -1
"c:\Users\rfrjo\pothole-detection-website\.next\static\webpack\92d17d5f338d6d65.webpack.hot-update.json", "JSON", 0, 0, 1, 0, 0, 0, 0, 1
"c:\Users\rfrjo\pothole-detection-website\.next\static\webpack\930cbca6693a54f4.webpack.hot-update.json", "JSON", 0, 0, -1, 0, 0, 0, 0, -1
"c:\Users\rfrjo\pothole-detection-website\.next\static\webpack\93cccf4e68c8f5fa.webpack.hot-update.json", "JSON", 0, 0, 1, 0, 0, 0, 0, 1
"c:\Users\rfrjo\pothole-detection-website\.next\static\webpack\94327a28070e9b59.webpack.hot-update.json", "JSON", 0, 0, 1, 0, 0, 0, 0, 1
"c:\Users\rfrjo\pothole-detection-website\.next\static\webpack\9494dc6d0ed8da0d.webpack.hot-update.json", "JSON", 0, 0, -1, 0, 0, 0, 0, -1
"c:\Users\rfrjo\pothole-detection-website\.next\static\webpack\949edd130e0d8b15.webpack.hot-update.json", "JSON", 0, 0, 1, 0, 0, 0, 0, 1
"c:\Users\rfrjo\pothole-detection-website\.next\static\webpack\9569517952febcf7.webpack.hot-update.json", "JSON", 0, 0, -1, 0, 0, 0, 0, -1
"c:\Users\rfrjo\pothole-detection-website\.next\static\webpack\9664f6c3a3baf5cb.webpack.hot-update.json", "JSON", 0, 0, -1, 0, 0, 0, 0, -1
"c:\Users\rfrjo\pothole-detection-website\.next\static\webpack\96ee604f28de5976.webpack.hot-update.json", "JSON", 0, 0, 1, 0, 0, 0, 0, 1
"c:\Users\rfrjo\pothole-detection-website\.next\static\webpack\972e47f8fdb1b92a.webpack.hot-update.json", "JSON", 0, 0, -1, 0, 0, 0, 0, -1
"c:\Users\rfrjo\pothole-detection-website\.next\static\webpack\988bbacd3bd4b4ed.webpack.hot-update.json", "JSON", 0, 0, -1, 0, 0, 0, 0, -1
"c:\Users\rfrjo\pothole-detection-website\.next\static\webpack\98a6d50291545cbd.webpack.hot-update.json", "JSON", 0, 0, -1, 0, 0, 0, 0, -1
"c:\Users\rfrjo\pothole-detection-website\.next\static\webpack\98f069abc21157d7.webpack.hot-update.json", "JSON", 0, 0, -1, 0, 0, 0, 0, -1
"c:\Users\rfrjo\pothole-detection-website\.next\static\webpack\994fc480f771c087.webpack.hot-update.json", "JSON", 0, 0, -1, 0, 0, 0, 0, -1
"c:\Users\rfrjo\pothole-detection-website\.next\static\webpack\99759e6ba0f88485.webpack.hot-update.json", "JSON", 0, 0, -1, 0, 0, 0, 0, -1
"c:\Users\rfrjo\pothole-detection-website\.next\static\webpack\998bbd00e52b9ad6.webpack.hot-update.json", "JSON", 0, 0, 1, 0, 0, 0, 0, 1
"c:\Users\rfrjo\pothole-detection-website\.next\static\webpack\9a3cb0f6c67b7b74.webpack.hot-update.json", "JSON", 0, 0, 1, 0, 0, 0, 0, 1
"c:\Users\rfrjo\pothole-detection-website\.next\static\webpack\9a469bb35965f49b.webpack.hot-update.json", "JSON", 0, 0, 1, 0, 0, 0, 0, 1
"c:\Users\rfrjo\pothole-detection-website\.next\static\webpack\9a9a2294c755eeb5.webpack.hot-update.json", "JSON", 0, 0, -1, 0, 0, 0, 0, -1
"c:\Users\rfrjo\pothole-detection-website\.next\static\webpack\9ab20fa73369eec1.webpack.hot-update.json", "JSON", 0, 0, -1, 0, 0, 0, 0, -1
"c:\Users\rfrjo\pothole-detection-website\.next\static\webpack\9ab9d809f1c15a7c.webpack.hot-update.json", "JSON", 0, 0, -1, 0, 0, 0, 0, -1
"c:\Users\rfrjo\pothole-detection-website\.next\static\webpack\9ad0b9331bbdf1ef.webpack.hot-update.json", "JSON", 0, 0, -1, 0, 0, 0, 0, -1
"c:\Users\rfrjo\pothole-detection-website\.next\static\webpack\9b177a6343dedfa5.webpack.hot-update.json", "JSON", 0, 0, 1, 0, 0, 0, 0, 1
"c:\Users\rfrjo\pothole-detection-website\.next\static\webpack\9b7dfac18cc1ecab.webpack.hot-update.json", "JSON", 0, 0, 1, 0, 0, 0, 0, 1
"c:\Users\rfrjo\pothole-detection-website\.next\static\webpack\9da82ad33978809b.webpack.hot-update.json", "JSON", 0, 0, -1, 0, 0, 0, 0, -1
"c:\Users\rfrjo\pothole-detection-website\.next\static\webpack\a2a68842df227705.webpack.hot-update.json", "JSON", 0, 0, -1, 0, 0, 0, 0, -1
"c:\Users\rfrjo\pothole-detection-website\.next\static\webpack\a63f32a84bd50758.webpack.hot-update.json", "JSON", 0, 0, -1, 0, 0, 0, 0, -1
"c:\Users\rfrjo\pothole-detection-website\.next\static\webpack\a6871c336bb962c8.webpack.hot-update.json", "JSON", 0, 0, -1, 0, 0, 0, 0, -1
"c:\Users\rfrjo\pothole-detection-website\.next\static\webpack\a6b97f6905db5af0.webpack.hot-update.json", "JSON", 0, 0, -1, 0, 0, 0, 0, -1
"c:\Users\rfrjo\pothole-detection-website\.next\static\webpack\a6f20656ebead5cb.webpack.hot-update.json", "JSON", 0, 0, -1, 0, 0, 0, 0, -1
"c:\Users\rfrjo\pothole-detection-website\.next\static\webpack\a7c0b93360be3965.webpack.hot-update.json", "JSON", 0, 0, -1, 0, 0, 0, 0, -1
"c:\Users\rfrjo\pothole-detection-website\.next\static\webpack\a83439c9a62dd260.webpack.hot-update.json", "JSON", 0, 0, -1, 0, 0, 0, 0, -1
"c:\Users\rfrjo\pothole-detection-website\.next\static\webpack\a88718d08d250638.webpack.hot-update.json", "JSON", 0, 0, 1, 0, 0, 0, 0, 1
"c:\Users\rfrjo\pothole-detection-website\.next\static\webpack\a926cb6e29706adb.webpack.hot-update.json", "JSON", 0, 0, -1, 0, 0, 0, 0, -1
"c:\Users\rfrjo\pothole-detection-website\.next\static\webpack\a9862d632b38a6ac.webpack.hot-update.json", "JSON", 0, 0, -1, 0, 0, 0, 0, -1
"c:\Users\rfrjo\pothole-detection-website\.next\static\webpack\aaf213d626cf9eed.webpack.hot-update.json", "JSON", 0, 0, -1, 0, 0, 0, 0, -1
"c:\Users\rfrjo\pothole-detection-website\.next\static\webpack\ac63d61331c9c256.webpack.hot-update.json", "JSON", 0, 0, -1, 0, 0, 0, 0, -1
"c:\Users\rfrjo\pothole-detection-website\.next\static\webpack\acceac5bfdb54fd8.webpack.hot-update.json", "JSON", 0, 0, 1, 0, 0, 0, 0, 1
"c:\Users\rfrjo\pothole-detection-website\.next\static\webpack\ae005569fba7523e.webpack.hot-update.json", "JSON", 0, 0, -1, 0, 0, 0, 0, -1
"c:\Users\rfrjo\pothole-detection-website\.next\static\webpack\af4f58f2e564eb2c.webpack.hot-update.json", "JSON", 0, 0, -1, 0, 0, 0, 0, -1
"c:\Users\rfrjo\pothole-detection-website\.next\static\webpack\afe8b402b606adb8.webpack.hot-update.json", "JSON", 0, 0, -1, 0, 0, 0, 0, -1
"c:\Users\rfrjo\pothole-detection-website\.next\static\webpack\app\dashboard\page.09f2854a07611b91.hot-update.js", "JavaScript", 7, 0, 0, 0, 0, 11, 4, 22
"c:\Users\rfrjo\pothole-detection-website\.next\static\webpack\app\dashboard\page.1019e17dc34f90f7.hot-update.js", "JavaScript", -7, 0, 0, 0, 0, -11, -4, -22
"c:\Users\rfrjo\pothole-detection-website\.next\static\webpack\app\dashboard\page.15533c9ad4427e70.hot-update.js", "JavaScript", -7, 0, 0, 0, 0, -11, -4, -22
"c:\Users\rfrjo\pothole-detection-website\.next\static\webpack\app\dashboard\page.1c32acae818838c2.hot-update.js", "JavaScript", -15, 0, 0, 0, 0, -17, -10, -42
"c:\Users\rfrjo\pothole-detection-website\.next\static\webpack\app\dashboard\page.1e178d13d373339b.hot-update.js", "JavaScript", -7, 0, 0, 0, 0, -11, -4, -22
"c:\Users\rfrjo\pothole-detection-website\.next\static\webpack\app\dashboard\page.1f834d24ad74b4f6.hot-update.js", "JavaScript", 7, 0, 0, 0, 0, 11, 4, 22
"c:\Users\rfrjo\pothole-detection-website\.next\static\webpack\app\dashboard\page.1f9d5f14b6b613da.hot-update.js", "JavaScript", -7, 0, 0, 0, 0, -11, -4, -22
"c:\Users\rfrjo\pothole-detection-website\.next\static\webpack\app\dashboard\page.2f8ca1b723b8efb7.hot-update.js", "JavaScript", -7, 0, 0, 0, 0, -11, -4, -22
"c:\Users\rfrjo\pothole-detection-website\.next\static\webpack\app\dashboard\page.3075e1cd05d6febe.hot-update.js", "JavaScript", -7, 0, 0, 0, 0, -11, -4, -22
"c:\Users\rfrjo\pothole-detection-website\.next\static\webpack\app\dashboard\page.36277ac7fedd49ae.hot-update.js", "JavaScript", -7, 0, 0, 0, 0, -11, -4, -22
"c:\Users\rfrjo\pothole-detection-website\.next\static\webpack\app\dashboard\page.36ecf676eed32104.hot-update.js", "JavaScript", -7, 0, 0, 0, 0, -11, -4, -22
"c:\Users\rfrjo\pothole-detection-website\.next\static\webpack\app\dashboard\page.3ceff98b83edd5ba.hot-update.js", "JavaScript", -7, 0, 0, 0, 0, -11, -4, -22
"c:\Users\rfrjo\pothole-detection-website\.next\static\webpack\app\dashboard\page.40295ba76eb93afd.hot-update.js", "JavaScript", -7, 0, 0, 0, 0, -11, -4, -22
"c:\Users\rfrjo\pothole-detection-website\.next\static\webpack\app\dashboard\page.437e40c658bb17cd.hot-update.js", "JavaScript", -7, 0, 0, 0, 0, -11, -4, -22
"c:\Users\rfrjo\pothole-detection-website\.next\static\webpack\app\dashboard\page.44288f0073fcc4b9.hot-update.js", "JavaScript", -7, 0, 0, 0, 0, -11, -4, -22
"c:\Users\rfrjo\pothole-detection-website\.next\static\webpack\app\dashboard\page.4aadc740f0277373.hot-update.js", "JavaScript", -7, 0, 0, 0, 0, -11, -4, -22
"c:\Users\rfrjo\pothole-detection-website\.next\static\webpack\app\dashboard\page.4df61bd6841d5eac.hot-update.js", "JavaScript", -7, 0, 0, 0, 0, -11, -4, -22
"c:\Users\rfrjo\pothole-detection-website\.next\static\webpack\app\dashboard\page.53e51f86ef56df26.hot-update.js", "JavaScript", -7, 0, 0, 0, 0, -11, -4, -22
"c:\Users\rfrjo\pothole-detection-website\.next\static\webpack\app\dashboard\page.54f6af229006dffa.hot-update.js", "JavaScript", -7, 0, 0, 0, 0, -11, -4, -22
"c:\Users\rfrjo\pothole-detection-website\.next\static\webpack\app\dashboard\page.59bfc2d9eba83495.hot-update.js", "JavaScript", -7, 0, 0, 0, 0, -11, -4, -22
"c:\Users\rfrjo\pothole-detection-website\.next\static\webpack\app\dashboard\page.5a3d1bcfab1dc770.hot-update.js", "JavaScript", -7, 0, 0, 0, 0, -11, -4, -22
"c:\Users\rfrjo\pothole-detection-website\.next\static\webpack\app\dashboard\page.5cabda8068dd9499.hot-update.js", "JavaScript", -7, 0, 0, 0, 0, -11, -4, -22
"c:\Users\rfrjo\pothole-detection-website\.next\static\webpack\app\dashboard\page.5ff81fa1db133655.hot-update.js", "JavaScript", -11, 0, 0, 0, 0, -14, -7, -32
"c:\Users\rfrjo\pothole-detection-website\.next\static\webpack\app\dashboard\page.63971713ced1858f.hot-update.js", "JavaScript", -67, 0, 0, 0, 0, -56, -49, -172
"c:\Users\rfrjo\pothole-detection-website\.next\static\webpack\app\dashboard\page.6526ad0581466889.hot-update.js", "JavaScript", -7, 0, 0, 0, 0, -11, -4, -22
"c:\Users\rfrjo\pothole-detection-website\.next\static\webpack\app\dashboard\page.6e00b59ed9168a3b.hot-update.js", "JavaScript", -7, 0, 0, 0, 0, -11, -4, -22
"c:\Users\rfrjo\pothole-detection-website\.next\static\webpack\app\dashboard\page.705b809a0da72e0a.hot-update.js", "JavaScript", -7, 0, 0, 0, 0, -11, -4, -22
"c:\Users\rfrjo\pothole-detection-website\.next\static\webpack\app\dashboard\page.71b4169a9c09d80b.hot-update.js", "JavaScript", -7, 0, 0, 0, 0, -11, -4, -22
"c:\Users\rfrjo\pothole-detection-website\.next\static\webpack\app\dashboard\page.78b9918761b7ec60.hot-update.js", "JavaScript", -7, 0, 0, 0, 0, -11, -4, -22
"c:\Users\rfrjo\pothole-detection-website\.next\static\webpack\app\dashboard\page.7e20b43409008cc0.hot-update.js", "JavaScript", -7, 0, 0, 0, 0, -11, -4, -22
"c:\Users\rfrjo\pothole-detection-website\.next\static\webpack\app\dashboard\page.836403eb24b7ffbd.hot-update.js", "JavaScript", -7, 0, 0, 0, 0, -11, -4, -22
"c:\Users\rfrjo\pothole-detection-website\.next\static\webpack\app\dashboard\page.87eae4974001cebd.hot-update.js", "JavaScript", -7, 0, 0, 0, 0, -11, -4, -22
"c:\Users\rfrjo\pothole-detection-website\.next\static\webpack\app\dashboard\page.90045a25807a574e.hot-update.js", "JavaScript", -7, 0, 0, 0, 0, -11, -4, -22
"c:\Users\rfrjo\pothole-detection-website\.next\static\webpack\app\dashboard\page.949edd130e0d8b15.hot-update.js", "JavaScript", 7, 0, 0, 0, 0, 11, 4, 22
"c:\Users\rfrjo\pothole-detection-website\.next\static\webpack\app\dashboard\page.972e47f8fdb1b92a.hot-update.js", "JavaScript", -7, 0, 0, 0, 0, -11, -4, -22
"c:\Users\rfrjo\pothole-detection-website\.next\static\webpack\app\dashboard\page.9ab20fa73369eec1.hot-update.js", "JavaScript", -7, 0, 0, 0, 0, -11, -4, -22
"c:\Users\rfrjo\pothole-detection-website\.next\static\webpack\app\dashboard\page.9da82ad33978809b.hot-update.js", "JavaScript", -11, 0, 0, 0, 0, -14, -7, -32
"c:\Users\rfrjo\pothole-detection-website\.next\static\webpack\app\dashboard\page.a2a68842df227705.hot-update.js", "JavaScript", -7, 0, 0, 0, 0, -11, -4, -22
"c:\Users\rfrjo\pothole-detection-website\.next\static\webpack\app\dashboard\page.a63f32a84bd50758.hot-update.js", "JavaScript", -7, 0, 0, 0, 0, -11, -4, -22
"c:\Users\rfrjo\pothole-detection-website\.next\static\webpack\app\dashboard\page.a6f20656ebead5cb.hot-update.js", "JavaScript", -7, 0, 0, 0, 0, -11, -4, -22
"c:\Users\rfrjo\pothole-detection-website\.next\static\webpack\app\dashboard\page.a83439c9a62dd260.hot-update.js", "JavaScript", -7, 0, 0, 0, 0, -11, -4, -22
"c:\Users\rfrjo\pothole-detection-website\.next\static\webpack\app\dashboard\page.a88718d08d250638.hot-update.js", "JavaScript", 7, 0, 0, 0, 0, 11, 4, 22
"c:\Users\rfrjo\pothole-detection-website\.next\static\webpack\app\dashboard\page.ac63d61331c9c256.hot-update.js", "JavaScript", -7, 0, 0, 0, 0, -11, -4, -22
"c:\Users\rfrjo\pothole-detection-website\.next\static\webpack\app\dashboard\page.b00e9254685beba5.hot-update.js", "JavaScript", -7, 0, 0, 0, 0, -11, -4, -22
"c:\Users\rfrjo\pothole-detection-website\.next\static\webpack\app\dashboard\page.b33251ce981b4e64.hot-update.js", "JavaScript", -7, 0, 0, 0, 0, -11, -4, -22
"c:\Users\rfrjo\pothole-detection-website\.next\static\webpack\app\dashboard\page.b356f9349f46c05f.hot-update.js", "JavaScript", -7, 0, 0, 0, 0, -11, -4, -22
"c:\Users\rfrjo\pothole-detection-website\.next\static\webpack\app\dashboard\page.b4935ee67ccb232c.hot-update.js", "JavaScript", 7, 0, 0, 0, 0, 11, 4, 22
"c:\Users\rfrjo\pothole-detection-website\.next\static\webpack\app\dashboard\page.ca06906c618b58c0.hot-update.js", "JavaScript", -7, 0, 0, 0, 0, -11, -4, -22
"c:\Users\rfrjo\pothole-detection-website\.next\static\webpack\app\dashboard\page.cc804bd8b794cc35.hot-update.js", "JavaScript", -7, 0, 0, 0, 0, -11, -4, -22
"c:\Users\rfrjo\pothole-detection-website\.next\static\webpack\app\dashboard\page.cc9db873835968af.hot-update.js", "JavaScript", -7, 0, 0, 0, 0, -11, -4, -22
"c:\Users\rfrjo\pothole-detection-website\.next\static\webpack\app\dashboard\page.cd8b500c9d524f82.hot-update.js", "JavaScript", -7, 0, 0, 0, 0, -11, -4, -22
"c:\Users\rfrjo\pothole-detection-website\.next\static\webpack\app\dashboard\page.cf5421d78a074520.hot-update.js", "JavaScript", -11, 0, 0, 0, 0, -14, -7, -32
"c:\Users\rfrjo\pothole-detection-website\.next\static\webpack\app\dashboard\page.d0e21abc3f17e927.hot-update.js", "JavaScript", -7, 0, 0, 0, 0, -11, -4, -22
"c:\Users\rfrjo\pothole-detection-website\.next\static\webpack\app\dashboard\page.d3f9d5d6accb4bbb.hot-update.js", "JavaScript", 41, 0, 0, 0, 0, 32, 25, 98
"c:\Users\rfrjo\pothole-detection-website\.next\static\webpack\app\dashboard\page.d4cfa901868645e2.hot-update.js", "JavaScript", 11, 0, 0, 0, 0, 14, 7, 32
"c:\Users\rfrjo\pothole-detection-website\.next\static\webpack\app\dashboard\page.d9d9e8eb36e4a319.hot-update.js", "JavaScript", -7, 0, 0, 0, 0, -11, -4, -22
"c:\Users\rfrjo\pothole-detection-website\.next\static\webpack\app\dashboard\page.dd156bdb1fdaed17.hot-update.js", "JavaScript", -7, 0, 0, 0, 0, -11, -4, -22
"c:\Users\rfrjo\pothole-detection-website\.next\static\webpack\app\dashboard\page.e0e9443637d32cb1.hot-update.js", "JavaScript", -7, 0, 0, 0, 0, -11, -4, -22
"c:\Users\rfrjo\pothole-detection-website\.next\static\webpack\app\dashboard\page.e90067ef8ce6181d.hot-update.js", "JavaScript", -7, 0, 0, 0, 0, -11, -4, -22
"c:\Users\rfrjo\pothole-detection-website\.next\static\webpack\app\dashboard\page.eafe582f0f415f2e.hot-update.js", "JavaScript", -7, 0, 0, 0, 0, -11, -4, -22
"c:\Users\rfrjo\pothole-detection-website\.next\static\webpack\app\dashboard\page.eea850992acc70bf.hot-update.js", "JavaScript", -7, 0, 0, 0, 0, -11, -4, -22
"c:\Users\rfrjo\pothole-detection-website\.next\static\webpack\app\dashboard\page.ef06e8bcc4d5cc20.hot-update.js", "JavaScript", -7, 0, 0, 0, 0, -11, -4, -22
"c:\Users\rfrjo\pothole-detection-website\.next\static\webpack\app\dashboard\page.f08265c37c969fb9.hot-update.js", "JavaScript", -7, 0, 0, 0, 0, -11, -4, -22
"c:\Users\rfrjo\pothole-detection-website\.next\static\webpack\app\dashboard\page.f47de2872720f503.hot-update.js", "JavaScript", -19, 0, 0, 0, 0, -20, -13, -52
"c:\Users\rfrjo\pothole-detection-website\.next\static\webpack\app\dashboard\page.fbe4fd7e0754fbdb.hot-update.js", "JavaScript", -7, 0, 0, 0, 0, -11, -4, -22
"c:\Users\rfrjo\pothole-detection-website\.next\static\webpack\app\dashboard\page.fc51d71f73067d3f.hot-update.js", "JavaScript", -7, 0, 0, 0, 0, -11, -4, -22
"c:\Users\rfrjo\pothole-detection-website\.next\static\webpack\app\dashboard\page.ffb54dfc8e5706f9.hot-update.js", "JavaScript", -7, 0, 0, 0, 0, -11, -4, -22
"c:\Users\rfrjo\pothole-detection-website\.next\static\webpack\app\detections\page.09f2854a07611b91.hot-update.js", "JavaScript", 7, 0, 0, 0, 0, 11, 4, 22
"c:\Users\rfrjo\pothole-detection-website\.next\static\webpack\app\detections\page.15533c9ad4427e70.hot-update.js", "JavaScript", -7, 0, 0, 0, 0, -11, -4, -22
"c:\Users\rfrjo\pothole-detection-website\.next\static\webpack\app\detections\page.1e178d13d373339b.hot-update.js", "JavaScript", -7, 0, 0, 0, 0, -11, -4, -22
"c:\Users\rfrjo\pothole-detection-website\.next\static\webpack\app\detections\page.1f834d24ad74b4f6.hot-update.js", "JavaScript", 7, 0, 0, 0, 0, 11, 4, 22
"c:\Users\rfrjo\pothole-detection-website\.next\static\webpack\app\detections\page.1f9d5f14b6b613da.hot-update.js", "JavaScript", -11, 0, 0, 0, 0, -14, -7, -32
"c:\Users\rfrjo\pothole-detection-website\.next\static\webpack\app\detections\page.2f8ca1b723b8efb7.hot-update.js", "JavaScript", -7, 0, 0, 0, 0, -11, -4, -22
"c:\Users\rfrjo\pothole-detection-website\.next\static\webpack\app\detections\page.36277ac7fedd49ae.hot-update.js", "JavaScript", -7, 0, 0, 0, 0, -11, -4, -22
"c:\Users\rfrjo\pothole-detection-website\.next\static\webpack\app\detections\page.36ecf676eed32104.hot-update.js", "JavaScript", -7, 0, 0, 0, 0, -11, -4, -22
"c:\Users\rfrjo\pothole-detection-website\.next\static\webpack\app\detections\page.3ceff98b83edd5ba.hot-update.js", "JavaScript", -7, 0, 0, 0, 0, -11, -4, -22
"c:\Users\rfrjo\pothole-detection-website\.next\static\webpack\app\detections\page.40295ba76eb93afd.hot-update.js", "JavaScript", -7, 0, 0, 0, 0, -11, -4, -22
"c:\Users\rfrjo\pothole-detection-website\.next\static\webpack\app\detections\page.44288f0073fcc4b9.hot-update.js", "JavaScript", -7, 0, 0, 0, 0, -11, -4, -22
"c:\Users\rfrjo\pothole-detection-website\.next\static\webpack\app\detections\page.4df61bd6841d5eac.hot-update.js", "JavaScript", -7, 0, 0, 0, 0, -11, -4, -22
"c:\Users\rfrjo\pothole-detection-website\.next\static\webpack\app\detections\page.53e51f86ef56df26.hot-update.js", "JavaScript", -7, 0, 0, 0, 0, -11, -4, -22
"c:\Users\rfrjo\pothole-detection-website\.next\static\webpack\app\detections\page.54f6af229006dffa.hot-update.js", "JavaScript", -7, 0, 0, 0, 0, -11, -4, -22
"c:\Users\rfrjo\pothole-detection-website\.next\static\webpack\app\detections\page.59bfc2d9eba83495.hot-update.js", "JavaScript", -7, 0, 0, 0, 0, -11, -4, -22
"c:\Users\rfrjo\pothole-detection-website\.next\static\webpack\app\detections\page.5a3d1bcfab1dc770.hot-update.js", "JavaScript", -7, 0, 0, 0, 0, -11, -4, -22
"c:\Users\rfrjo\pothole-detection-website\.next\static\webpack\app\detections\page.6526ad0581466889.hot-update.js", "JavaScript", -7, 0, 0, 0, 0, -11, -4, -22
"c:\Users\rfrjo\pothole-detection-website\.next\static\webpack\app\detections\page.6e00b59ed9168a3b.hot-update.js", "JavaScript", -7, 0, 0, 0, 0, -11, -4, -22
"c:\Users\rfrjo\pothole-detection-website\.next\static\webpack\app\detections\page.705b809a0da72e0a.hot-update.js", "JavaScript", -7, 0, 0, 0, 0, -11, -4, -22
"c:\Users\rfrjo\pothole-detection-website\.next\static\webpack\app\detections\page.71b4169a9c09d80b.hot-update.js", "JavaScript", -7, 0, 0, 0, 0, -11, -4, -22
"c:\Users\rfrjo\pothole-detection-website\.next\static\webpack\app\detections\page.788ddaeb2bb2bb7b.hot-update.js", "JavaScript", -26, 0, 0, 0, 0, -23, -16, -65
"c:\Users\rfrjo\pothole-detection-website\.next\static\webpack\app\detections\page.78b9918761b7ec60.hot-update.js", "JavaScript", -7, 0, 0, 0, 0, -11, -4, -22
"c:\Users\rfrjo\pothole-detection-website\.next\static\webpack\app\detections\page.7e20b43409008cc0.hot-update.js", "JavaScript", -7, 0, 0, 0, 0, -11, -4, -22
"c:\Users\rfrjo\pothole-detection-website\.next\static\webpack\app\detections\page.836403eb24b7ffbd.hot-update.js", "JavaScript", -7, 0, 0, 0, 0, -11, -4, -22
"c:\Users\rfrjo\pothole-detection-website\.next\static\webpack\app\detections\page.87eae4974001cebd.hot-update.js", "JavaScript", -7, 0, 0, 0, 0, -11, -4, -22
"c:\Users\rfrjo\pothole-detection-website\.next\static\webpack\app\detections\page.8cfc7e3849acd858.hot-update.js", "JavaScript", -7, 0, 0, 0, 0, -11, -4, -22
"c:\Users\rfrjo\pothole-detection-website\.next\static\webpack\app\detections\page.90045a25807a574e.hot-update.js", "JavaScript", -7, 0, 0, 0, 0, -11, -4, -22
"c:\Users\rfrjo\pothole-detection-website\.next\static\webpack\app\detections\page.949edd130e0d8b15.hot-update.js", "JavaScript", 7, 0, 0, 0, 0, 11, 4, 22
"c:\Users\rfrjo\pothole-detection-website\.next\static\webpack\app\detections\page.972e47f8fdb1b92a.hot-update.js", "JavaScript", -7, 0, 0, 0, 0, -11, -4, -22
"c:\Users\rfrjo\pothole-detection-website\.next\static\webpack\app\detections\page.9ab20fa73369eec1.hot-update.js", "JavaScript", -7, 0, 0, 0, 0, -11, -4, -22
"c:\Users\rfrjo\pothole-detection-website\.next\static\webpack\app\detections\page.9da82ad33978809b.hot-update.js", "JavaScript", -7, 0, 0, 0, 0, -11, -4, -22
"c:\Users\rfrjo\pothole-detection-website\.next\static\webpack\app\detections\page.a2a68842df227705.hot-update.js", "JavaScript", -7, 0, 0, 0, 0, -11, -4, -22
"c:\Users\rfrjo\pothole-detection-website\.next\static\webpack\app\detections\page.a63f32a84bd50758.hot-update.js", "JavaScript", -7, 0, 0, 0, 0, -11, -4, -22
"c:\Users\rfrjo\pothole-detection-website\.next\static\webpack\app\detections\page.a6f20656ebead5cb.hot-update.js", "JavaScript", -7, 0, 0, 0, 0, -11, -4, -22
"c:\Users\rfrjo\pothole-detection-website\.next\static\webpack\app\detections\page.a83439c9a62dd260.hot-update.js", "JavaScript", -11, 0, 0, 0, 0, -14, -7, -32
"c:\Users\rfrjo\pothole-detection-website\.next\static\webpack\app\detections\page.a88718d08d250638.hot-update.js", "JavaScript", 7, 0, 0, 0, 0, 11, 4, 22
"c:\Users\rfrjo\pothole-detection-website\.next\static\webpack\app\detections\page.ac63d61331c9c256.hot-update.js", "JavaScript", -7, 0, 0, 0, 0, -11, -4, -22
"c:\Users\rfrjo\pothole-detection-website\.next\static\webpack\app\detections\page.b00e9254685beba5.hot-update.js", "JavaScript", -7, 0, 0, 0, 0, -11, -4, -22
"c:\Users\rfrjo\pothole-detection-website\.next\static\webpack\app\detections\page.b356f9349f46c05f.hot-update.js", "JavaScript", -11, 0, 0, 0, 0, -14, -7, -32
"c:\Users\rfrjo\pothole-detection-website\.next\static\webpack\app\detections\page.b4935ee67ccb232c.hot-update.js", "JavaScript", 7, 0, 0, 0, 0, 11, 4, 22
"c:\Users\rfrjo\pothole-detection-website\.next\static\webpack\app\detections\page.ca06906c618b58c0.hot-update.js", "JavaScript", -7, 0, 0, 0, 0, -11, -4, -22
"c:\Users\rfrjo\pothole-detection-website\.next\static\webpack\app\detections\page.cc804bd8b794cc35.hot-update.js", "JavaScript", -7, 0, 0, 0, 0, -11, -4, -22
"c:\Users\rfrjo\pothole-detection-website\.next\static\webpack\app\detections\page.cc9db873835968af.hot-update.js", "JavaScript", -7, 0, 0, 0, 0, -11, -4, -22
"c:\Users\rfrjo\pothole-detection-website\.next\static\webpack\app\detections\page.cd8b500c9d524f82.hot-update.js", "JavaScript", -7, 0, 0, 0, 0, -11, -4, -22
"c:\Users\rfrjo\pothole-detection-website\.next\static\webpack\app\detections\page.d0e21abc3f17e927.hot-update.js", "JavaScript", -7, 0, 0, 0, 0, -11, -4, -22
"c:\Users\rfrjo\pothole-detection-website\.next\static\webpack\app\detections\page.dd156bdb1fdaed17.hot-update.js", "JavaScript", -7, 0, 0, 0, 0, -11, -4, -22
"c:\Users\rfrjo\pothole-detection-website\.next\static\webpack\app\detections\page.e90067ef8ce6181d.hot-update.js", "JavaScript", -7, 0, 0, 0, 0, -11, -4, -22
"c:\Users\rfrjo\pothole-detection-website\.next\static\webpack\app\detections\page.eea850992acc70bf.hot-update.js", "JavaScript", -11, 0, 0, 0, 0, -14, -7, -32
"c:\Users\rfrjo\pothole-detection-website\.next\static\webpack\app\detections\page.ef06e8bcc4d5cc20.hot-update.js", "JavaScript", -7, 0, 0, 0, 0, -11, -4, -22
"c:\Users\rfrjo\pothole-detection-website\.next\static\webpack\app\detections\page.f08265c37c969fb9.hot-update.js", "JavaScript", -7, 0, 0, 0, 0, -11, -4, -22
"c:\Users\rfrjo\pothole-detection-website\.next\static\webpack\app\detections\page.fbe4fd7e0754fbdb.hot-update.js", "JavaScript", -7, 0, 0, 0, 0, -11, -4, -22
"c:\Users\rfrjo\pothole-detection-website\.next\static\webpack\app\detections\page.fc51d71f73067d3f.hot-update.js", "JavaScript", -7, 0, 0, 0, 0, -11, -4, -22
"c:\Users\rfrjo\pothole-detection-website\.next\static\webpack\app\help\page.09f2854a07611b91.hot-update.js", "JavaScript", 7, 0, 0, 0, 0, 11, 4, 22
"c:\Users\rfrjo\pothole-detection-website\.next\static\webpack\app\help\page.15533c9ad4427e70.hot-update.js", "JavaScript", -7, 0, 0, 0, 0, -11, -4, -22
"c:\Users\rfrjo\pothole-detection-website\.next\static\webpack\app\help\page.1e178d13d373339b.hot-update.js", "JavaScript", -7, 0, 0, 0, 0, -11, -4, -22
"c:\Users\rfrjo\pothole-detection-website\.next\static\webpack\app\help\page.1f834d24ad74b4f6.hot-update.js", "JavaScript", 7, 0, 0, 0, 0, 11, 4, 22
"c:\Users\rfrjo\pothole-detection-website\.next\static\webpack\app\help\page.1f9d5f14b6b613da.hot-update.js", "JavaScript", -11, 0, 0, 0, 0, -14, -7, -32
"c:\Users\rfrjo\pothole-detection-website\.next\static\webpack\app\help\page.2f8ca1b723b8efb7.hot-update.js", "JavaScript", -7, 0, 0, 0, 0, -11, -4, -22
"c:\Users\rfrjo\pothole-detection-website\.next\static\webpack\app\help\page.36277ac7fedd49ae.hot-update.js", "JavaScript", -7, 0, 0, 0, 0, -11, -4, -22
"c:\Users\rfrjo\pothole-detection-website\.next\static\webpack\app\help\page.36ecf676eed32104.hot-update.js", "JavaScript", -7, 0, 0, 0, 0, -11, -4, -22
"c:\Users\rfrjo\pothole-detection-website\.next\static\webpack\app\help\page.3ceff98b83edd5ba.hot-update.js", "JavaScript", -7, 0, 0, 0, 0, -11, -4, -22
"c:\Users\rfrjo\pothole-detection-website\.next\static\webpack\app\help\page.40295ba76eb93afd.hot-update.js", "JavaScript", -7, 0, 0, 0, 0, -11, -4, -22
"c:\Users\rfrjo\pothole-detection-website\.next\static\webpack\app\help\page.44288f0073fcc4b9.hot-update.js", "JavaScript", -7, 0, 0, 0, 0, -11, -4, -22
"c:\Users\rfrjo\pothole-detection-website\.next\static\webpack\app\help\page.4df61bd6841d5eac.hot-update.js", "JavaScript", -7, 0, 0, 0, 0, -11, -4, -22
"c:\Users\rfrjo\pothole-detection-website\.next\static\webpack\app\help\page.53e51f86ef56df26.hot-update.js", "JavaScript", -7, 0, 0, 0, 0, -11, -4, -22
"c:\Users\rfrjo\pothole-detection-website\.next\static\webpack\app\help\page.54f6af229006dffa.hot-update.js", "JavaScript", -7, 0, 0, 0, 0, -11, -4, -22
"c:\Users\rfrjo\pothole-detection-website\.next\static\webpack\app\help\page.59bfc2d9eba83495.hot-update.js", "JavaScript", -7, 0, 0, 0, 0, -11, -4, -22
"c:\Users\rfrjo\pothole-detection-website\.next\static\webpack\app\help\page.5a3d1bcfab1dc770.hot-update.js", "JavaScript", -7, 0, 0, 0, 0, -11, -4, -22
"c:\Users\rfrjo\pothole-detection-website\.next\static\webpack\app\help\page.6526ad0581466889.hot-update.js", "JavaScript", -7, 0, 0, 0, 0, -11, -4, -22
"c:\Users\rfrjo\pothole-detection-website\.next\static\webpack\app\help\page.6e00b59ed9168a3b.hot-update.js", "JavaScript", -7, 0, 0, 0, 0, -11, -4, -22
"c:\Users\rfrjo\pothole-detection-website\.next\static\webpack\app\help\page.705b809a0da72e0a.hot-update.js", "JavaScript", -7, 0, 0, 0, 0, -11, -4, -22
"c:\Users\rfrjo\pothole-detection-website\.next\static\webpack\app\help\page.71b4169a9c09d80b.hot-update.js", "JavaScript", -7, 0, 0, 0, 0, -11, -4, -22
"c:\Users\rfrjo\pothole-detection-website\.next\static\webpack\app\help\page.78b9918761b7ec60.hot-update.js", "JavaScript", -7, 0, 0, 0, 0, -11, -4, -22
"c:\Users\rfrjo\pothole-detection-website\.next\static\webpack\app\help\page.7e20b43409008cc0.hot-update.js", "JavaScript", -7, 0, 0, 0, 0, -11, -4, -22
"c:\Users\rfrjo\pothole-detection-website\.next\static\webpack\app\help\page.836403eb24b7ffbd.hot-update.js", "JavaScript", -7, 0, 0, 0, 0, -11, -4, -22
"c:\Users\rfrjo\pothole-detection-website\.next\static\webpack\app\help\page.87eae4974001cebd.hot-update.js", "JavaScript", -7, 0, 0, 0, 0, -11, -4, -22
"c:\Users\rfrjo\pothole-detection-website\.next\static\webpack\app\help\page.89bd7cc19491664a.hot-update.js", "JavaScript", -41, 0, 0, 0, 0, -32, -25, -98
"c:\Users\rfrjo\pothole-detection-website\.next\static\webpack\app\help\page.8cfc7e3849acd858.hot-update.js", "JavaScript", -7, 0, 0, 0, 0, -11, -4, -22
"c:\Users\rfrjo\pothole-detection-website\.next\static\webpack\app\help\page.90045a25807a574e.hot-update.js", "JavaScript", -7, 0, 0, 0, 0, -11, -4, -22
"c:\Users\rfrjo\pothole-detection-website\.next\static\webpack\app\help\page.949edd130e0d8b15.hot-update.js", "JavaScript", 7, 0, 0, 0, 0, 11, 4, 22
"c:\Users\rfrjo\pothole-detection-website\.next\static\webpack\app\help\page.972e47f8fdb1b92a.hot-update.js", "JavaScript", -7, 0, 0, 0, 0, -11, -4, -22
"c:\Users\rfrjo\pothole-detection-website\.next\static\webpack\app\help\page.9ab20fa73369eec1.hot-update.js", "JavaScript", -7, 0, 0, 0, 0, -11, -4, -22
"c:\Users\rfrjo\pothole-detection-website\.next\static\webpack\app\help\page.9da82ad33978809b.hot-update.js", "JavaScript", -7, 0, 0, 0, 0, -11, -4, -22
"c:\Users\rfrjo\pothole-detection-website\.next\static\webpack\app\help\page.a2a68842df227705.hot-update.js", "JavaScript", -7, 0, 0, 0, 0, -11, -4, -22
"c:\Users\rfrjo\pothole-detection-website\.next\static\webpack\app\help\page.a63f32a84bd50758.hot-update.js", "JavaScript", -7, 0, 0, 0, 0, -11, -4, -22
"c:\Users\rfrjo\pothole-detection-website\.next\static\webpack\app\help\page.a6f20656ebead5cb.hot-update.js", "JavaScript", -7, 0, 0, 0, 0, -11, -4, -22
"c:\Users\rfrjo\pothole-detection-website\.next\static\webpack\app\help\page.a83439c9a62dd260.hot-update.js", "JavaScript", -11, 0, 0, 0, 0, -14, -7, -32
"c:\Users\rfrjo\pothole-detection-website\.next\static\webpack\app\help\page.a88718d08d250638.hot-update.js", "JavaScript", 7, 0, 0, 0, 0, 11, 4, 22
"c:\Users\rfrjo\pothole-detection-website\.next\static\webpack\app\help\page.ac63d61331c9c256.hot-update.js", "JavaScript", -7, 0, 0, 0, 0, -11, -4, -22
"c:\Users\rfrjo\pothole-detection-website\.next\static\webpack\app\help\page.b00e9254685beba5.hot-update.js", "JavaScript", -7, 0, 0, 0, 0, -11, -4, -22
"c:\Users\rfrjo\pothole-detection-website\.next\static\webpack\app\help\page.b356f9349f46c05f.hot-update.js", "JavaScript", -11, 0, 0, 0, 0, -14, -7, -32
"c:\Users\rfrjo\pothole-detection-website\.next\static\webpack\app\help\page.b4935ee67ccb232c.hot-update.js", "JavaScript", 7, 0, 0, 0, 0, 11, 4, 22
"c:\Users\rfrjo\pothole-detection-website\.next\static\webpack\app\help\page.ca06906c618b58c0.hot-update.js", "JavaScript", -7, 0, 0, 0, 0, -11, -4, -22
"c:\Users\rfrjo\pothole-detection-website\.next\static\webpack\app\help\page.cc804bd8b794cc35.hot-update.js", "JavaScript", -7, 0, 0, 0, 0, -11, -4, -22
"c:\Users\rfrjo\pothole-detection-website\.next\static\webpack\app\help\page.cc9db873835968af.hot-update.js", "JavaScript", -7, 0, 0, 0, 0, -11, -4, -22
"c:\Users\rfrjo\pothole-detection-website\.next\static\webpack\app\help\page.cd8b500c9d524f82.hot-update.js", "JavaScript", -7, 0, 0, 0, 0, -11, -4, -22
"c:\Users\rfrjo\pothole-detection-website\.next\static\webpack\app\help\page.d0e21abc3f17e927.hot-update.js", "JavaScript", -7, 0, 0, 0, 0, -11, -4, -22
"c:\Users\rfrjo\pothole-detection-website\.next\static\webpack\app\help\page.d4cfa901868645e2.hot-update.js", "JavaScript", 7, 0, 0, 0, 0, 11, 4, 22
"c:\Users\rfrjo\pothole-detection-website\.next\static\webpack\app\help\page.dd156bdb1fdaed17.hot-update.js", "JavaScript", -7, 0, 0, 0, 0, -11, -4, -22
"c:\Users\rfrjo\pothole-detection-website\.next\static\webpack\app\help\page.e90067ef8ce6181d.hot-update.js", "JavaScript", -7, 0, 0, 0, 0, -11, -4, -22
"c:\Users\rfrjo\pothole-detection-website\.next\static\webpack\app\help\page.eea850992acc70bf.hot-update.js", "JavaScript", -11, 0, 0, 0, 0, -14, -7, -32
"c:\Users\rfrjo\pothole-detection-website\.next\static\webpack\app\help\page.ef06e8bcc4d5cc20.hot-update.js", "JavaScript", -7, 0, 0, 0, 0, -11, -4, -22
"c:\Users\rfrjo\pothole-detection-website\.next\static\webpack\app\help\page.f08265c37c969fb9.hot-update.js", "JavaScript", -7, 0, 0, 0, 0, -11, -4, -22
"c:\Users\rfrjo\pothole-detection-website\.next\static\webpack\app\help\page.fbe4fd7e0754fbdb.hot-update.js", "JavaScript", -7, 0, 0, 0, 0, -11, -4, -22
"c:\Users\rfrjo\pothole-detection-website\.next\static\webpack\app\help\page.fc51d71f73067d3f.hot-update.js", "JavaScript", -7, 0, 0, 0, 0, -11, -4, -22
"c:\Users\rfrjo\pothole-detection-website\.next\static\webpack\app\layout.03f416adaa618df1.hot-update.js", "JavaScript", 7, 0, 0, 0, 0, 11, 4, 22
"c:\Users\rfrjo\pothole-detection-website\.next\static\webpack\app\layout.052f6dea2efbf9c3.hot-update.js", "JavaScript", 7, 0, 0, 0, 0, 11, 4, 22
"c:\Users\rfrjo\pothole-detection-website\.next\static\webpack\app\layout.05715a168cba21da.hot-update.js", "JavaScript", 7, 0, 0, 0, 0, 11, 4, 22
"c:\Users\rfrjo\pothole-detection-website\.next\static\webpack\app\layout.08e6a1720712c1de.hot-update.js", "JavaScript", -7, 0, 0, 0, 0, -11, -4, -22
"c:\Users\rfrjo\pothole-detection-website\.next\static\webpack\app\layout.09f2854a07611b91.hot-update.js", "JavaScript", 7, 0, 0, 0, 0, 11, 4, 22
"c:\Users\rfrjo\pothole-detection-website\.next\static\webpack\app\layout.0e556f7ecf57b136.hot-update.js", "JavaScript", -7, 0, 0, 0, 0, -11, -4, -22
"c:\Users\rfrjo\pothole-detection-website\.next\static\webpack\app\layout.0ef0af934fc2b140.hot-update.js", "JavaScript", -7, 0, 0, 0, 0, -11, -4, -22
"c:\Users\rfrjo\pothole-detection-website\.next\static\webpack\app\layout.0f59587d0a6f5dd0.hot-update.js", "JavaScript", 7, 0, 0, 0, 0, 11, 4, 22
"c:\Users\rfrjo\pothole-detection-website\.next\static\webpack\app\layout.1019e17dc34f90f7.hot-update.js", "JavaScript", -7, 0, 0, 0, 0, -11, -4, -22
"c:\Users\rfrjo\pothole-detection-website\.next\static\webpack\app\layout.10f36f7c29af944b.hot-update.js", "JavaScript", -7, 0, 0, 0, 0, -11, -4, -22
"c:\Users\rfrjo\pothole-detection-website\.next\static\webpack\app\layout.11f5b055fd4bd836.hot-update.js", "JavaScript", -7, 0, 0, 0, 0, -11, -4, -22
"c:\Users\rfrjo\pothole-detection-website\.next\static\webpack\app\layout.15533c9ad4427e70.hot-update.js", "JavaScript", -7, 0, 0, 0, 0, -11, -4, -22
"c:\Users\rfrjo\pothole-detection-website\.next\static\webpack\app\layout.16a32586d354b631.hot-update.js", "JavaScript", 7, 0, 0, 0, 0, 11, 4, 22
"c:\Users\rfrjo\pothole-detection-website\.next\static\webpack\app\layout.1b6b2212351d04eb.hot-update.js", "JavaScript", 7, 0, 0, 0, 0, 11, 4, 22
"c:\Users\rfrjo\pothole-detection-website\.next\static\webpack\app\layout.1bf57e9ca108224a.hot-update.js", "JavaScript", 7, 0, 0, 0, 0, 11, 4, 22
"c:\Users\rfrjo\pothole-detection-website\.next\static\webpack\app\layout.1c27704668b698fe.hot-update.js", "JavaScript", -7, 0, 0, 0, 0, -11, -4, -22
"c:\Users\rfrjo\pothole-detection-website\.next\static\webpack\app\layout.1c32acae818838c2.hot-update.js", "JavaScript", -19, 0, 0, 0, 0, -20, -13, -52
"c:\Users\rfrjo\pothole-detection-website\.next\static\webpack\app\layout.1d5788842318190b.hot-update.js", "JavaScript", 7, 0, 0, 0, 0, 11, 4, 22
"c:\Users\rfrjo\pothole-detection-website\.next\static\webpack\app\layout.1e178d13d373339b.hot-update.js", "JavaScript", -7, 0, 0, 0, 0, -11, -4, -22
"c:\Users\rfrjo\pothole-detection-website\.next\static\webpack\app\layout.1eaa88a0999b1364.hot-update.js", "JavaScript", -7, 0, 0, 0, 0, -11, -4, -22
"c:\Users\rfrjo\pothole-detection-website\.next\static\webpack\app\layout.1f834d24ad74b4f6.hot-update.js", "JavaScript", 7, 0, 0, 0, 0, 11, 4, 22
"c:\Users\rfrjo\pothole-detection-website\.next\static\webpack\app\layout.1f9d5f14b6b613da.hot-update.js", "JavaScript", -7, 0, 0, 0, 0, -11, -4, -22
"c:\Users\rfrjo\pothole-detection-website\.next\static\webpack\app\layout.237a39fa8ef5c6e3.hot-update.js", "JavaScript", -7, 0, 0, 0, 0, -11, -4, -22
"c:\Users\rfrjo\pothole-detection-website\.next\static\webpack\app\layout.23a5b02801af775d.hot-update.js", "JavaScript", -7, 0, 0, 0, 0, -11, -4, -22
"c:\Users\rfrjo\pothole-detection-website\.next\static\webpack\app\layout.241e6549ff2bdfb9.hot-update.js", "JavaScript", 7, 0, 0, 0, 0, 11, 4, 22
"c:\Users\rfrjo\pothole-detection-website\.next\static\webpack\app\layout.2437995ad6de6d44.hot-update.js", "JavaScript", 7, 0, 0, 0, 0, 11, 4, 22
"c:\Users\rfrjo\pothole-detection-website\.next\static\webpack\app\layout.2447dcefc4d408c0.hot-update.js", "JavaScript", 7, 0, 0, 0, 0, 11, 4, 22
"c:\Users\rfrjo\pothole-detection-website\.next\static\webpack\app\layout.25e2634e463d29f1.hot-update.js", "JavaScript", -7, 0, 0, 0, 0, -11, -4, -22
"c:\Users\rfrjo\pothole-detection-website\.next\static\webpack\app\layout.261582b8a4c03c81.hot-update.js", "JavaScript", 7, 0, 0, 0, 0, 11, 4, 22
"c:\Users\rfrjo\pothole-detection-website\.next\static\webpack\app\layout.26b9be174d75f607.hot-update.js", "JavaScript", -7, 0, 0, 0, 0, -11, -4, -22
"c:\Users\rfrjo\pothole-detection-website\.next\static\webpack\app\layout.27f6d42552c967a9.hot-update.js", "JavaScript", -7, 0, 0, 0, 0, -11, -4, -22
"c:\Users\rfrjo\pothole-detection-website\.next\static\webpack\app\layout.2af20e4231425d85.hot-update.js", "JavaScript", 7, 0, 0, 0, 0, 11, 4, 22
"c:\Users\rfrjo\pothole-detection-website\.next\static\webpack\app\layout.2bfff34f33985a5c.hot-update.js", "JavaScript", 7, 0, 0, 0, 0, 11, 4, 22
"c:\Users\rfrjo\pothole-detection-website\.next\static\webpack\app\layout.2c8586f1d74b8d89.hot-update.js", "JavaScript", -7, 0, 0, 0, 0, -11, -4, -22
"c:\Users\rfrjo\pothole-detection-website\.next\static\webpack\app\layout.2df75f17c78eeaf1.hot-update.js", "JavaScript", 7, 0, 0, 0, 0, 11, 4, 22
"c:\Users\rfrjo\pothole-detection-website\.next\static\webpack\app\layout.2f8ca1b723b8efb7.hot-update.js", "JavaScript", -7, 0, 0, 0, 0, -11, -4, -22
"c:\Users\rfrjo\pothole-detection-website\.next\static\webpack\app\layout.3075e1cd05d6febe.hot-update.js", "JavaScript", -7, 0, 0, 0, 0, -11, -4, -22
"c:\Users\rfrjo\pothole-detection-website\.next\static\webpack\app\layout.336c5b89b535e2de.hot-update.js", "JavaScript", 7, 0, 0, 0, 0, 11, 4, 22
"c:\Users\rfrjo\pothole-detection-website\.next\static\webpack\app\layout.35543311e684b41b.hot-update.js", "JavaScript", -7, 0, 0, 0, 0, -11, -4, -22
"c:\Users\rfrjo\pothole-detection-website\.next\static\webpack\app\layout.35bbf55acd2f0777.hot-update.js", "JavaScript", -7, 0, 0, 0, 0, -11, -4, -22
"c:\Users\rfrjo\pothole-detection-website\.next\static\webpack\app\layout.36277ac7fedd49ae.hot-update.js", "JavaScript", -7, 0, 0, 0, 0, -11, -4, -22
"c:\Users\rfrjo\pothole-detection-website\.next\static\webpack\app\layout.366f97835718ae55.hot-update.js", "JavaScript", -7, 0, 0, 0, 0, -11, -4, -22
"c:\Users\rfrjo\pothole-detection-website\.next\static\webpack\app\layout.36ecf676eed32104.hot-update.js", "JavaScript", -7, 0, 0, 0, 0, -11, -4, -22
"c:\Users\rfrjo\pothole-detection-website\.next\static\webpack\app\layout.382141e07fdcde74.hot-update.js", "JavaScript", -7, 0, 0, 0, 0, -11, -4, -22
"c:\Users\rfrjo\pothole-detection-website\.next\static\webpack\app\layout.395562a4717d2f7f.hot-update.js", "JavaScript", 7, 0, 0, 0, 0, 11, 4, 22
"c:\Users\rfrjo\pothole-detection-website\.next\static\webpack\app\layout.3af8302a34ff3f9b.hot-update.js", "JavaScript", 7, 0, 0, 0, 0, 11, 4, 22
"c:\Users\rfrjo\pothole-detection-website\.next\static\webpack\app\layout.3c4b6483cb36fe68.hot-update.js", "JavaScript", -7, 0, 0, 0, 0, -11, -4, -22
"c:\Users\rfrjo\pothole-detection-website\.next\static\webpack\app\layout.3ceff98b83edd5ba.hot-update.js", "JavaScript", -7, 0, 0, 0, 0, -11, -4, -22
"c:\Users\rfrjo\pothole-detection-website\.next\static\webpack\app\layout.3d3bada15a49a51a.hot-update.js", "JavaScript", 7, 0, 0, 0, 0, 11, 4, 22
"c:\Users\rfrjo\pothole-detection-website\.next\static\webpack\app\layout.3fd574372d51d356.hot-update.js", "JavaScript", -7, 0, 0, 0, 0, -11, -4, -22
"c:\Users\rfrjo\pothole-detection-website\.next\static\webpack\app\layout.40295ba76eb93afd.hot-update.js", "JavaScript", -7, 0, 0, 0, 0, -11, -4, -22
"c:\Users\rfrjo\pothole-detection-website\.next\static\webpack\app\layout.404846168f14f227.hot-update.js", "JavaScript", -7, 0, 0, 0, 0, -11, -4, -22
"c:\Users\rfrjo\pothole-detection-website\.next\static\webpack\app\layout.437e40c658bb17cd.hot-update.js", "JavaScript", -7, 0, 0, 0, 0, -11, -4, -22
"c:\Users\rfrjo\pothole-detection-website\.next\static\webpack\app\layout.44288f0073fcc4b9.hot-update.js", "JavaScript", -7, 0, 0, 0, 0, -11, -4, -22
"c:\Users\rfrjo\pothole-detection-website\.next\static\webpack\app\layout.47396008231a81e3.hot-update.js", "JavaScript", 7, 0, 0, 0, 0, 11, 4, 22
"c:\Users\rfrjo\pothole-detection-website\.next\static\webpack\app\layout.478146370f32c537.hot-update.js", "JavaScript", -7, 0, 0, 0, 0, -11, -4, -22
"c:\Users\rfrjo\pothole-detection-website\.next\static\webpack\app\layout.4936085bfb196153.hot-update.js", "JavaScript", -7, 0, 0, 0, 0, -11, -4, -22
"c:\Users\rfrjo\pothole-detection-website\.next\static\webpack\app\layout.4973ea30c81c600a.hot-update.js", "JavaScript", -7, 0, 0, 0, 0, -11, -4, -22
"c:\Users\rfrjo\pothole-detection-website\.next\static\webpack\app\layout.497efc25dbe6dd76.hot-update.js", "JavaScript", -7, 0, 0, 0, 0, -11, -4, -22
"c:\Users\rfrjo\pothole-detection-website\.next\static\webpack\app\layout.499d0255c918291e.hot-update.js", "JavaScript", -7, 0, 0, 0, 0, -11, -4, -22
"c:\Users\rfrjo\pothole-detection-website\.next\static\webpack\app\layout.4aadc740f0277373.hot-update.js", "JavaScript", -7, 0, 0, 0, 0, -11, -4, -22
"c:\Users\rfrjo\pothole-detection-website\.next\static\webpack\app\layout.4b294efc754c21b7.hot-update.js", "JavaScript", -7, 0, 0, 0, 0, -11, -4, -22
"c:\Users\rfrjo\pothole-detection-website\.next\static\webpack\app\layout.4be6c3196b0e7880.hot-update.js", "JavaScript", 7, 0, 0, 0, 0, 11, 4, 22
"c:\Users\rfrjo\pothole-detection-website\.next\static\webpack\app\layout.4df61bd6841d5eac.hot-update.js", "JavaScript", -7, 0, 0, 0, 0, -11, -4, -22
"c:\Users\rfrjo\pothole-detection-website\.next\static\webpack\app\layout.4e4c07c1c572ae5f.hot-update.js", "JavaScript", 7, 0, 0, 0, 0, 11, 4, 22
"c:\Users\rfrjo\pothole-detection-website\.next\static\webpack\app\layout.4e7177463858ed6a.hot-update.js", "JavaScript", 7, 0, 0, 0, 0, 11, 4, 22
"c:\Users\rfrjo\pothole-detection-website\.next\static\webpack\app\layout.4ff81d283a481acd.hot-update.js", "JavaScript", -7, 0, 0, 0, 0, -11, -4, -22
"c:\Users\rfrjo\pothole-detection-website\.next\static\webpack\app\layout.52a6ee1060dbb5bd.hot-update.js", "JavaScript", -7, 0, 0, 0, 0, -11, -4, -22
"c:\Users\rfrjo\pothole-detection-website\.next\static\webpack\app\layout.536a639bf7e5e9f4.hot-update.js", "JavaScript", -7, 0, 0, 0, 0, -11, -4, -22
"c:\Users\rfrjo\pothole-detection-website\.next\static\webpack\app\layout.53e51f86ef56df26.hot-update.js", "JavaScript", -7, 0, 0, 0, 0, -11, -4, -22
"c:\Users\rfrjo\pothole-detection-website\.next\static\webpack\app\layout.54f6af229006dffa.hot-update.js", "JavaScript", -7, 0, 0, 0, 0, -11, -4, -22
"c:\Users\rfrjo\pothole-detection-website\.next\static\webpack\app\layout.55c1de0576594fd6.hot-update.js", "JavaScript", -7, 0, 0, 0, 0, -11, -4, -22
"c:\Users\rfrjo\pothole-detection-website\.next\static\webpack\app\layout.568a68dbfa67aef9.hot-update.js", "JavaScript", -7, 0, 0, 0, 0, -11, -4, -22
"c:\Users\rfrjo\pothole-detection-website\.next\static\webpack\app\layout.599be672b367805b.hot-update.js", "JavaScript", 7, 0, 0, 0, 0, 11, 4, 22
"c:\Users\rfrjo\pothole-detection-website\.next\static\webpack\app\layout.59bfc2d9eba83495.hot-update.js", "JavaScript", -7, 0, 0, 0, 0, -11, -4, -22
"c:\Users\rfrjo\pothole-detection-website\.next\static\webpack\app\layout.59f4dd90ac1f2a7b.hot-update.js", "JavaScript", -7, 0, 0, 0, 0, -11, -4, -22
"c:\Users\rfrjo\pothole-detection-website\.next\static\webpack\app\layout.5a3d1bcfab1dc770.hot-update.js", "JavaScript", -7, 0, 0, 0, 0, -11, -4, -22
"c:\Users\rfrjo\pothole-detection-website\.next\static\webpack\app\layout.5ab59c38990547bb.hot-update.js", "JavaScript", -7, 0, 0, 0, 0, -11, -4, -22
"c:\Users\rfrjo\pothole-detection-website\.next\static\webpack\app\layout.5bbc0606b035f308.hot-update.js", "JavaScript", -7, 0, 0, 0, 0, -11, -4, -22
"c:\Users\rfrjo\pothole-detection-website\.next\static\webpack\app\layout.5c91122845ef46d4.hot-update.js", "JavaScript", -7, 0, 0, 0, 0, -11, -4, -22
"c:\Users\rfrjo\pothole-detection-website\.next\static\webpack\app\layout.5cabda8068dd9499.hot-update.js", "JavaScript", -7, 0, 0, 0, 0, -11, -4, -22
"c:\Users\rfrjo\pothole-detection-website\.next\static\webpack\app\layout.5ff81fa1db133655.hot-update.js", "JavaScript", -7, 0, 0, 0, 0, -11, -4, -22
"c:\Users\rfrjo\pothole-detection-website\.next\static\webpack\app\layout.611d7ddaf6eaaea5.hot-update.js", "JavaScript", 7, 0, 0, 0, 0, 11, 4, 22
"c:\Users\rfrjo\pothole-detection-website\.next\static\webpack\app\layout.629b8911cc520362.hot-update.js", "JavaScript", -7, 0, 0, 0, 0, -11, -4, -22
"c:\Users\rfrjo\pothole-detection-website\.next\static\webpack\app\layout.63971713ced1858f.hot-update.js", "JavaScript", -11, 0, 0, 0, 0, -14, -7, -32
"c:\Users\rfrjo\pothole-detection-website\.next\static\webpack\app\layout.64ce06dd8784dad5.hot-update.js", "JavaScript", 7, 0, 0, 0, 0, 11, 4, 22
"c:\Users\rfrjo\pothole-detection-website\.next\static\webpack\app\layout.6526ad0581466889.hot-update.js", "JavaScript", -7, 0, 0, 0, 0, -11, -4, -22
"c:\Users\rfrjo\pothole-detection-website\.next\static\webpack\app\layout.6542ad685ec8b80d.hot-update.js", "JavaScript", -7, 0, 0, 0, 0, -11, -4, -22
"c:\Users\rfrjo\pothole-detection-website\.next\static\webpack\app\layout.6c4c64dd3db346a4.hot-update.js", "JavaScript", -7, 0, 0, 0, 0, -11, -4, -22
"c:\Users\rfrjo\pothole-detection-website\.next\static\webpack\app\layout.6e00b59ed9168a3b.hot-update.js", "JavaScript", -7, 0, 0, 0, 0, -11, -4, -22
"c:\Users\rfrjo\pothole-detection-website\.next\static\webpack\app\layout.6e17eea08daa4461.hot-update.js", "JavaScript", 7, 0, 0, 0, 0, 11, 4, 22
"c:\Users\rfrjo\pothole-detection-website\.next\static\webpack\app\layout.6f49d563ee97279e.hot-update.js", "JavaScript", -7, 0, 0, 0, 0, -11, -4, -22
"c:\Users\rfrjo\pothole-detection-website\.next\static\webpack\app\layout.6f4e069acbdb7f44.hot-update.js", "JavaScript", -7, 0, 0, 0, 0, -11, -4, -22
"c:\Users\rfrjo\pothole-detection-website\.next\static\webpack\app\layout.704ada73f32ffcfe.hot-update.js", "JavaScript", 7, 0, 0, 0, 0, 11, 4, 22
"c:\Users\rfrjo\pothole-detection-website\.next\static\webpack\app\layout.705b809a0da72e0a.hot-update.js", "JavaScript", -7, 0, 0, 0, 0, -11, -4, -22
"c:\Users\rfrjo\pothole-detection-website\.next\static\webpack\app\layout.7117d69c4d8dd1f0.hot-update.js", "JavaScript", -7, 0, 0, 0, 0, -11, -4, -22
"c:\Users\rfrjo\pothole-detection-website\.next\static\webpack\app\layout.718317dae5cd0fbb.hot-update.js", "JavaScript", -7, 0, 0, 0, 0, -11, -4, -22
"c:\Users\rfrjo\pothole-detection-website\.next\static\webpack\app\layout.71b4169a9c09d80b.hot-update.js", "JavaScript", -7, 0, 0, 0, 0, -11, -4, -22
"c:\Users\rfrjo\pothole-detection-website\.next\static\webpack\app\layout.72539884909e2f51.hot-update.js", "JavaScript", -7, 0, 0, 0, 0, -11, -4, -22
"c:\Users\rfrjo\pothole-detection-website\.next\static\webpack\app\layout.72e8be227edd0633.hot-update.js", "JavaScript", 7, 0, 0, 0, 0, 11, 4, 22
"c:\Users\rfrjo\pothole-detection-website\.next\static\webpack\app\layout.74bf66b145b7f31a.hot-update.js", "JavaScript", 7, 0, 0, 0, 0, 11, 4, 22
"c:\Users\rfrjo\pothole-detection-website\.next\static\webpack\app\layout.7553387ad1cc69a3.hot-update.js", "JavaScript", 7, 0, 0, 0, 0, 11, 4, 22
"c:\Users\rfrjo\pothole-detection-website\.next\static\webpack\app\layout.76d95935b394a037.hot-update.js", "JavaScript", -7, 0, 0, 0, 0, -11, -4, -22
"c:\Users\rfrjo\pothole-detection-website\.next\static\webpack\app\layout.771791e9f93ad77e.hot-update.js", "JavaScript", -7, 0, 0, 0, 0, -11, -4, -22
"c:\Users\rfrjo\pothole-detection-website\.next\static\webpack\app\layout.7724e64c228ec499.hot-update.js", "JavaScript", -7, 0, 0, 0, 0, -11, -4, -22
"c:\Users\rfrjo\pothole-detection-website\.next\static\webpack\app\layout.788ddaeb2bb2bb7b.hot-update.js", "JavaScript", -7, 0, 0, 0, 0, -11, -4, -22
"c:\Users\rfrjo\pothole-detection-website\.next\static\webpack\app\layout.78b9918761b7ec60.hot-update.js", "JavaScript", -7, 0, 0, 0, 0, -11, -4, -22
"c:\Users\rfrjo\pothole-detection-website\.next\static\webpack\app\layout.7c3c6c0fb7269248.hot-update.js", "JavaScript", -7, 0, 0, 0, 0, -11, -4, -22
"c:\Users\rfrjo\pothole-detection-website\.next\static\webpack\app\layout.7e20b43409008cc0.hot-update.js", "JavaScript", -7, 0, 0, 0, 0, -11, -4, -22
"c:\Users\rfrjo\pothole-detection-website\.next\static\webpack\app\layout.80818ec3b62912ab.hot-update.js", "JavaScript", -7, 0, 0, 0, 0, -11, -4, -22
"c:\Users\rfrjo\pothole-detection-website\.next\static\webpack\app\layout.82bcae466be0d753.hot-update.js", "JavaScript", 7, 0, 0, 0, 0, 11, 4, 22
"c:\Users\rfrjo\pothole-detection-website\.next\static\webpack\app\layout.830fc07e3aa56e50.hot-update.js", "JavaScript", -7, 0, 0, 0, 0, -11, -4, -22
"c:\Users\rfrjo\pothole-detection-website\.next\static\webpack\app\layout.836403eb24b7ffbd.hot-update.js", "JavaScript", -7, 0, 0, 0, 0, -11, -4, -22
"c:\Users\rfrjo\pothole-detection-website\.next\static\webpack\app\layout.84b6aaa9e7aab2e2.hot-update.js", "JavaScript", -7, 0, 0, 0, 0, -11, -4, -22
"c:\Users\rfrjo\pothole-detection-website\.next\static\webpack\app\layout.854534e54fe1e890.hot-update.js", "JavaScript", -7, 0, 0, 0, 0, -11, -4, -22
"c:\Users\rfrjo\pothole-detection-website\.next\static\webpack\app\layout.863a15ead088bba9.hot-update.js", "JavaScript", -7, 0, 0, 0, 0, -11, -4, -22
"c:\Users\rfrjo\pothole-detection-website\.next\static\webpack\app\layout.87eae4974001cebd.hot-update.js", "JavaScript", -7, 0, 0, 0, 0, -11, -4, -22
"c:\Users\rfrjo\pothole-detection-website\.next\static\webpack\app\layout.8894e59acb5af99a.hot-update.js", "JavaScript", -7, 0, 0, 0, 0, -11, -4, -22
"c:\Users\rfrjo\pothole-detection-website\.next\static\webpack\app\layout.8ce78540ee6b936c.hot-update.js", "JavaScript", 7, 0, 0, 0, 0, 11, 4, 22
"c:\Users\rfrjo\pothole-detection-website\.next\static\webpack\app\layout.8cfc7e3849acd858.hot-update.js", "JavaScript", -7, 0, 0, 0, 0, -11, -4, -22
"c:\Users\rfrjo\pothole-detection-website\.next\static\webpack\app\layout.8d1022a00db06c96.hot-update.js", "JavaScript", 7, 0, 0, 0, 0, 11, 4, 22
"c:\Users\rfrjo\pothole-detection-website\.next\static\webpack\app\layout.8fd824ed7d27ab5d.hot-update.js", "JavaScript", -7, 0, 0, 0, 0, -11, -4, -22
"c:\Users\rfrjo\pothole-detection-website\.next\static\webpack\app\layout.90045a25807a574e.hot-update.js", "JavaScript", -7, 0, 0, 0, 0, -11, -4, -22
"c:\Users\rfrjo\pothole-detection-website\.next\static\webpack\app\layout.90600ccfb467a9cb.hot-update.js", "JavaScript", 7, 0, 0, 0, 0, 11, 4, 22
"c:\Users\rfrjo\pothole-detection-website\.next\static\webpack\app\layout.9066f5ce9def0675.hot-update.js", "JavaScript", -7, 0, 0, 0, 0, -11, -4, -22
"c:\Users\rfrjo\pothole-detection-website\.next\static\webpack\app\layout.930cbca6693a54f4.hot-update.js", "JavaScript", -7, 0, 0, 0, 0, -11, -4, -22
"c:\Users\rfrjo\pothole-detection-website\.next\static\webpack\app\layout.93cccf4e68c8f5fa.hot-update.js", "JavaScript", 7, 0, 0, 0, 0, 11, 4, 22
"c:\Users\rfrjo\pothole-detection-website\.next\static\webpack\app\layout.94327a28070e9b59.hot-update.js", "JavaScript", 7, 0, 0, 0, 0, 11, 4, 22
"c:\Users\rfrjo\pothole-detection-website\.next\static\webpack\app\layout.9494dc6d0ed8da0d.hot-update.js", "JavaScript", -7, 0, 0, 0, 0, -11, -4, -22
"c:\Users\rfrjo\pothole-detection-website\.next\static\webpack\app\layout.949edd130e0d8b15.hot-update.js", "JavaScript", 7, 0, 0, 0, 0, 11, 4, 22
"c:\Users\rfrjo\pothole-detection-website\.next\static\webpack\app\layout.9569517952febcf7.hot-update.js", "JavaScript", -7, 0, 0, 0, 0, -11, -4, -22
"c:\Users\rfrjo\pothole-detection-website\.next\static\webpack\app\layout.9664f6c3a3baf5cb.hot-update.js", "JavaScript", -7, 0, 0, 0, 0, -11, -4, -22
"c:\Users\rfrjo\pothole-detection-website\.next\static\webpack\app\layout.96ee604f28de5976.hot-update.js", "JavaScript", 7, 0, 0, 0, 0, 11, 4, 22
"c:\Users\rfrjo\pothole-detection-website\.next\static\webpack\app\layout.972e47f8fdb1b92a.hot-update.js", "JavaScript", -7, 0, 0, 0, 0, -11, -4, -22
"c:\Users\rfrjo\pothole-detection-website\.next\static\webpack\app\layout.988bbacd3bd4b4ed.hot-update.js", "JavaScript", -7, 0, 0, 0, 0, -11, -4, -22
"c:\Users\rfrjo\pothole-detection-website\.next\static\webpack\app\layout.98a6d50291545cbd.hot-update.js", "JavaScript", -7, 0, 0, 0, 0, -11, -4, -22
"c:\Users\rfrjo\pothole-detection-website\.next\static\webpack\app\layout.98f069abc21157d7.hot-update.js", "JavaScript", -7, 0, 0, 0, 0, -11, -4, -22
"c:\Users\rfrjo\pothole-detection-website\.next\static\webpack\app\layout.99759e6ba0f88485.hot-update.js", "JavaScript", -7, 0, 0, 0, 0, -11, -4, -22
"c:\Users\rfrjo\pothole-detection-website\.next\static\webpack\app\layout.998bbd00e52b9ad6.hot-update.js", "JavaScript", 7, 0, 0, 0, 0, 11, 4, 22
"c:\Users\rfrjo\pothole-detection-website\.next\static\webpack\app\layout.9a3cb0f6c67b7b74.hot-update.js", "JavaScript", 7, 0, 0, 0, 0, 11, 4, 22
"c:\Users\rfrjo\pothole-detection-website\.next\static\webpack\app\layout.9a469bb35965f49b.hot-update.js", "JavaScript", 7, 0, 0, 0, 0, 11, 4, 22
"c:\Users\rfrjo\pothole-detection-website\.next\static\webpack\app\layout.9a9a2294c755eeb5.hot-update.js", "JavaScript", -7, 0, 0, 0, 0, -11, -4, -22
"c:\Users\rfrjo\pothole-detection-website\.next\static\webpack\app\layout.9ab20fa73369eec1.hot-update.js", "JavaScript", -7, 0, 0, 0, 0, -11, -4, -22
"c:\Users\rfrjo\pothole-detection-website\.next\static\webpack\app\layout.9ab9d809f1c15a7c.hot-update.js", "JavaScript", -7, 0, 0, 0, 0, -11, -4, -22
"c:\Users\rfrjo\pothole-detection-website\.next\static\webpack\app\layout.9b177a6343dedfa5.hot-update.js", "JavaScript", 7, 0, 0, 0, 0, 11, 4, 22
"c:\Users\rfrjo\pothole-detection-website\.next\static\webpack\app\layout.9b7dfac18cc1ecab.hot-update.js", "JavaScript", 7, 0, 0, 0, 0, 11, 4, 22
"c:\Users\rfrjo\pothole-detection-website\.next\static\webpack\app\layout.9da82ad33978809b.hot-update.js", "JavaScript", -7, 0, 0, 0, 0, -11, -4, -22
"c:\Users\rfrjo\pothole-detection-website\.next\static\webpack\app\layout.a2a68842df227705.hot-update.js", "JavaScript", -7, 0, 0, 0, 0, -11, -4, -22
"c:\Users\rfrjo\pothole-detection-website\.next\static\webpack\app\layout.a63f32a84bd50758.hot-update.js", "JavaScript", -7, 0, 0, 0, 0, -11, -4, -22
"c:\Users\rfrjo\pothole-detection-website\.next\static\webpack\app\layout.a6871c336bb962c8.hot-update.js", "JavaScript", -7, 0, 0, 0, 0, -11, -4, -22
"c:\Users\rfrjo\pothole-detection-website\.next\static\webpack\app\layout.a6b97f6905db5af0.hot-update.js", "JavaScript", -7, 0, 0, 0, 0, -11, -4, -22
"c:\Users\rfrjo\pothole-detection-website\.next\static\webpack\app\layout.a6f20656ebead5cb.hot-update.js", "JavaScript", -7, 0, 0, 0, 0, -11, -4, -22
"c:\Users\rfrjo\pothole-detection-website\.next\static\webpack\app\layout.a83439c9a62dd260.hot-update.js", "JavaScript", -7, 0, 0, 0, 0, -11, -4, -22
"c:\Users\rfrjo\pothole-detection-website\.next\static\webpack\app\layout.a88718d08d250638.hot-update.js", "JavaScript", 7, 0, 0, 0, 0, 11, 4, 22
"c:\Users\rfrjo\pothole-detection-website\.next\static\webpack\app\layout.a9862d632b38a6ac.hot-update.js", "JavaScript", -7, 0, 0, 0, 0, -11, -4, -22
"c:\Users\rfrjo\pothole-detection-website\.next\static\webpack\app\layout.aaf213d626cf9eed.hot-update.js", "JavaScript", -7, 0, 0, 0, 0, -11, -4, -22
"c:\Users\rfrjo\pothole-detection-website\.next\static\webpack\app\layout.ac63d61331c9c256.hot-update.js", "JavaScript", -7, 0, 0, 0, 0, -11, -4, -22
"c:\Users\rfrjo\pothole-detection-website\.next\static\webpack\app\layout.acceac5bfdb54fd8.hot-update.js", "JavaScript", 7, 0, 0, 0, 0, 11, 4, 22
"c:\Users\rfrjo\pothole-detection-website\.next\static\webpack\app\layout.ae005569fba7523e.hot-update.js", "JavaScript", -7, 0, 0, 0, 0, -11, -4, -22
"c:\Users\rfrjo\pothole-detection-website\.next\static\webpack\app\layout.b00e9254685beba5.hot-update.js", "JavaScript", -7, 0, 0, 0, 0, -11, -4, -22
"c:\Users\rfrjo\pothole-detection-website\.next\static\webpack\app\layout.b33251ce981b4e64.hot-update.js", "JavaScript", -11, 0, 0, 0, 0, -14, -7, -32
"c:\Users\rfrjo\pothole-detection-website\.next\static\webpack\app\layout.b356f9349f46c05f.hot-update.js", "JavaScript", -7, 0, 0, 0, 0, -11, -4, -22
"c:\Users\rfrjo\pothole-detection-website\.next\static\webpack\app\layout.b4935ee67ccb232c.hot-update.js", "JavaScript", 7, 0, 0, 0, 0, 11, 4, 22
"c:\Users\rfrjo\pothole-detection-website\.next\static\webpack\app\layout.b6fccb5d616f7190.hot-update.js", "JavaScript", -7, 0, 0, 0, 0, -11, -4, -22
"c:\Users\rfrjo\pothole-detection-website\.next\static\webpack\app\layout.b724e9efc9d6f974.hot-update.js", "JavaScript", -7, 0, 0, 0, 0, -11, -4, -22
"c:\Users\rfrjo\pothole-detection-website\.next\static\webpack\app\layout.b9b6070c1ac65dfc.hot-update.js", "JavaScript", -100, 0, 0, 0, 0, -68, -61, -229
"c:\Users\rfrjo\pothole-detection-website\.next\static\webpack\app\layout.ba3c414df75c4b96.hot-update.js", "JavaScript", -7, 0, 0, 0, 0, -11, -4, -22
"c:\Users\rfrjo\pothole-detection-website\.next\static\webpack\app\layout.bd975f57d9c1d99b.hot-update.js", "JavaScript", -7, 0, 0, 0, 0, -11, -4, -22
"c:\Users\rfrjo\pothole-detection-website\.next\static\webpack\app\layout.be3da15174200697.hot-update.js", "JavaScript", 7, 0, 0, 0, 0, 11, 4, 22
"c:\Users\rfrjo\pothole-detection-website\.next\static\webpack\app\layout.be3e42fe055d75c9.hot-update.js", "JavaScript", 7, 0, 0, 0, 0, 11, 4, 22
"c:\Users\rfrjo\pothole-detection-website\.next\static\webpack\app\layout.c174dae197df82fa.hot-update.js", "JavaScript", 7, 0, 0, 0, 0, 11, 4, 22
"c:\Users\rfrjo\pothole-detection-website\.next\static\webpack\app\layout.c2f90dd08b817d3a.hot-update.js", "JavaScript", -7, 0, 0, 0, 0, -11, -4, -22
"c:\Users\rfrjo\pothole-detection-website\.next\static\webpack\app\layout.c4ba3707ef3455b0.hot-update.js", "JavaScript", 7, 0, 0, 0, 0, 11, 4, 22
"c:\Users\rfrjo\pothole-detection-website\.next\static\webpack\app\layout.c7ebeba584f48140.hot-update.js", "JavaScript", -7, 0, 0, 0, 0, -11, -4, -22
"c:\Users\rfrjo\pothole-detection-website\.next\static\webpack\app\layout.c863c433a47baf3d.hot-update.js", "JavaScript", 7, 0, 0, 0, 0, 11, 4, 22
"c:\Users\rfrjo\pothole-detection-website\.next\static\webpack\app\layout.ca06906c618b58c0.hot-update.js", "JavaScript", -7, 0, 0, 0, 0, -11, -4, -22
"c:\Users\rfrjo\pothole-detection-website\.next\static\webpack\app\layout.cc78697ad538e48d.hot-update.js", "JavaScript", -7, 0, 0, 0, 0, -11, -4, -22
"c:\Users\rfrjo\pothole-detection-website\.next\static\webpack\app\layout.cc804bd8b794cc35.hot-update.js", "JavaScript", -7, 0, 0, 0, 0, -11, -4, -22
"c:\Users\rfrjo\pothole-detection-website\.next\static\webpack\app\layout.cc9db873835968af.hot-update.js", "JavaScript", -7, 0, 0, 0, 0, -11, -4, -22
"c:\Users\rfrjo\pothole-detection-website\.next\static\webpack\app\layout.cd33e8b75fd3d567.hot-update.js", "JavaScript", 7, 0, 0, 0, 0, 11, 4, 22
"c:\Users\rfrjo\pothole-detection-website\.next\static\webpack\app\layout.cd3728e5463e40ac.hot-update.js", "JavaScript", 7, 0, 0, 0, 0, 11, 4, 22
"c:\Users\rfrjo\pothole-detection-website\.next\static\webpack\app\layout.cd8b500c9d524f82.hot-update.js", "JavaScript", -7, 0, 0, 0, 0, -11, -4, -22
"c:\Users\rfrjo\pothole-detection-website\.next\static\webpack\app\layout.cddbb80b4fa7f701.hot-update.js", "JavaScript", -7, 0, 0, 0, 0, -11, -4, -22
"c:\Users\rfrjo\pothole-detection-website\.next\static\webpack\app\layout.cf1be1f66aaef90c.hot-update.js", "JavaScript", 7, 0, 0, 0, 0, 11, 4, 22
"c:\Users\rfrjo\pothole-detection-website\.next\static\webpack\app\layout.cf5421d78a074520.hot-update.js", "JavaScript", -7, 0, 0, 0, 0, -11, -4, -22
"c:\Users\rfrjo\pothole-detection-website\.next\static\webpack\app\layout.d0e21abc3f17e927.hot-update.js", "JavaScript", -7, 0, 0, 0, 0, -11, -4, -22
"c:\Users\rfrjo\pothole-detection-website\.next\static\webpack\app\layout.d2b39e3fbc806218.hot-update.js", "JavaScript", 7, 0, 0, 0, 0, 11, 4, 22
"c:\Users\rfrjo\pothole-detection-website\.next\static\webpack\app\layout.d35bcc164f83e081.hot-update.js", "JavaScript", -7, 0, 0, 0, 0, -11, -4, -22
"c:\Users\rfrjo\pothole-detection-website\.next\static\webpack\app\layout.d3f9d5d6accb4bbb.hot-update.js", "JavaScript", 41, 0, 0, 0, 0, 32, 25, 98
"c:\Users\rfrjo\pothole-detection-website\.next\static\webpack\app\layout.d46b0477114cd521.hot-update.js", "JavaScript", -7, 0, 0, 0, 0, -11, -4, -22
"c:\Users\rfrjo\pothole-detection-website\.next\static\webpack\app\layout.d4cfa901868645e2.hot-update.js", "JavaScript", 11, 0, 0, 0, 0, 14, 7, 32
"c:\Users\rfrjo\pothole-detection-website\.next\static\webpack\app\layout.d7f4b3c0f1019bfb.hot-update.js", "JavaScript", -7, 0, 0, 0, 0, -11, -4, -22
"c:\Users\rfrjo\pothole-detection-website\.next\static\webpack\app\layout.d811744dbedd33fe.hot-update.js", "JavaScript", -7, 0, 0, 0, 0, -11, -4, -22
"c:\Users\rfrjo\pothole-detection-website\.next\static\webpack\app\layout.d8b408ff1213441e.hot-update.js", "JavaScript", 7, 0, 0, 0, 0, 11, 4, 22
"c:\Users\rfrjo\pothole-detection-website\.next\static\webpack\app\layout.d9a2c09833ac5b84.hot-update.js", "JavaScript", -7, 0, 0, 0, 0, -11, -4, -22
"c:\Users\rfrjo\pothole-detection-website\.next\static\webpack\app\layout.d9d9e8eb36e4a319.hot-update.js", "JavaScript", -7, 0, 0, 0, 0, -11, -4, -22
"c:\Users\rfrjo\pothole-detection-website\.next\static\webpack\app\layout.da189dca28b2fd71.hot-update.js", "JavaScript", -7, 0, 0, 0, 0, -11, -4, -22
"c:\Users\rfrjo\pothole-detection-website\.next\static\webpack\app\layout.da6ee9ed3accfd7c.hot-update.js", "JavaScript", -7, 0, 0, 0, 0, -11, -4, -22
"c:\Users\rfrjo\pothole-detection-website\.next\static\webpack\app\layout.dc9aabb6db3bc5e2.hot-update.js", "JavaScript", -7, 0, 0, 0, 0, -11, -4, -22
"c:\Users\rfrjo\pothole-detection-website\.next\static\webpack\app\layout.dd156bdb1fdaed17.hot-update.js", "JavaScript", -7, 0, 0, 0, 0, -11, -4, -22
"c:\Users\rfrjo\pothole-detection-website\.next\static\webpack\app\layout.df6583e3b6affbbb.hot-update.js", "JavaScript", 7, 0, 0, 0, 0, 11, 4, 22
"c:\Users\rfrjo\pothole-detection-website\.next\static\webpack\app\layout.e0aa062d3cdf4a32.hot-update.js", "JavaScript", -7, 0, 0, 0, 0, -11, -4, -22
"c:\Users\rfrjo\pothole-detection-website\.next\static\webpack\app\layout.e0e9443637d32cb1.hot-update.js", "JavaScript", -7, 0, 0, 0, 0, -11, -4, -22
"c:\Users\rfrjo\pothole-detection-website\.next\static\webpack\app\layout.e10874c4bc226ea0.hot-update.js", "JavaScript", -7, 0, 0, 0, 0, -11, -4, -22
"c:\Users\rfrjo\pothole-detection-website\.next\static\webpack\app\layout.e3ff949e143f65d2.hot-update.js", "JavaScript", -7, 0, 0, 0, 0, -11, -4, -22
"c:\Users\rfrjo\pothole-detection-website\.next\static\webpack\app\layout.e8591e517137c060.hot-update.js", "JavaScript", -7, 0, 0, 0, 0, -11, -4, -22
"c:\Users\rfrjo\pothole-detection-website\.next\static\webpack\app\layout.e8b3f5af01348270.hot-update.js", "JavaScript", 7, 0, 0, 0, 0, 11, 4, 22
"c:\Users\rfrjo\pothole-detection-website\.next\static\webpack\app\layout.e90067ef8ce6181d.hot-update.js", "JavaScript", -7, 0, 0, 0, 0, -11, -4, -22
"c:\Users\rfrjo\pothole-detection-website\.next\static\webpack\app\layout.eafe582f0f415f2e.hot-update.js", "JavaScript", -7, 0, 0, 0, 0, -11, -4, -22
"c:\Users\rfrjo\pothole-detection-website\.next\static\webpack\app\layout.eb31eec642aac43d.hot-update.js", "JavaScript", -7, 0, 0, 0, 0, -11, -4, -22
"c:\Users\rfrjo\pothole-detection-website\.next\static\webpack\app\layout.eb6c58442bbef117.hot-update.js", "JavaScript", -7, 0, 0, 0, 0, -11, -4, -22
"c:\Users\rfrjo\pothole-detection-website\.next\static\webpack\app\layout.ee0348281aac2ba8.hot-update.js", "JavaScript", -7, 0, 0, 0, 0, -11, -4, -22
"c:\Users\rfrjo\pothole-detection-website\.next\static\webpack\app\layout.eea850992acc70bf.hot-update.js", "JavaScript", -7, 0, 0, 0, 0, -11, -4, -22
"c:\Users\rfrjo\pothole-detection-website\.next\static\webpack\app\layout.eec024fae8f4e249.hot-update.js", "JavaScript", -7, 0, 0, 0, 0, -11, -4, -22
"c:\Users\rfrjo\pothole-detection-website\.next\static\webpack\app\layout.ef06e8bcc4d5cc20.hot-update.js", "JavaScript", -7, 0, 0, 0, 0, -11, -4, -22
"c:\Users\rfrjo\pothole-detection-website\.next\static\webpack\app\layout.f00f7e380c8004ef.hot-update.js", "JavaScript", 7, 0, 0, 0, 0, 11, 4, 22
"c:\Users\rfrjo\pothole-detection-website\.next\static\webpack\app\layout.f08265c37c969fb9.hot-update.js", "JavaScript", -7, 0, 0, 0, 0, -11, -4, -22
"c:\Users\rfrjo\pothole-detection-website\.next\static\webpack\app\layout.f33d64cb0afa3b86.hot-update.js", "JavaScript", -7, 0, 0, 0, 0, -11, -4, -22
"c:\Users\rfrjo\pothole-detection-website\.next\static\webpack\app\layout.f3561c083243df06.hot-update.js", "JavaScript", -7, 0, 0, 0, 0, -11, -4, -22
"c:\Users\rfrjo\pothole-detection-website\.next\static\webpack\app\layout.f47b825168d22aa0.hot-update.js", "JavaScript", -7, 0, 0, 0, 0, -11, -4, -22
"c:\Users\rfrjo\pothole-detection-website\.next\static\webpack\app\layout.f47de2872720f503.hot-update.js", "JavaScript", -7, 0, 0, 0, 0, -11, -4, -22
"c:\Users\rfrjo\pothole-detection-website\.next\static\webpack\app\layout.f51ef73fe7ab9246.hot-update.js", "JavaScript", 7, 0, 0, 0, 0, 11, 4, 22
"c:\Users\rfrjo\pothole-detection-website\.next\static\webpack\app\layout.f71e8e55740cd286.hot-update.js", "JavaScript", 7, 0, 0, 0, 0, 11, 4, 22
"c:\Users\rfrjo\pothole-detection-website\.next\static\webpack\app\layout.f88d041dae8d9828.hot-update.js", "JavaScript", 7, 0, 0, 0, 0, 11, 4, 22
"c:\Users\rfrjo\pothole-detection-website\.next\static\webpack\app\layout.f9520265e142ad5e.hot-update.js", "JavaScript", -7, 0, 0, 0, 0, -11, -4, -22
"c:\Users\rfrjo\pothole-detection-website\.next\static\webpack\app\layout.f9c5fb343c296e1c.hot-update.js", "JavaScript", 7, 0, 0, 0, 0, 11, 4, 22
"c:\Users\rfrjo\pothole-detection-website\.next\static\webpack\app\layout.f9de1ca68fbbf2ec.hot-update.js", "JavaScript", 7, 0, 0, 0, 0, 11, 4, 22
"c:\Users\rfrjo\pothole-detection-website\.next\static\webpack\app\layout.fa7fd5fadcff3ac4.hot-update.js", "JavaScript", -7, 0, 0, 0, 0, -11, -4, -22
"c:\Users\rfrjo\pothole-detection-website\.next\static\webpack\app\layout.fb7ae82af7c3ab0d.hot-update.js", "JavaScript", 7, 0, 0, 0, 0, 11, 4, 22
"c:\Users\rfrjo\pothole-detection-website\.next\static\webpack\app\layout.fbe4fd7e0754fbdb.hot-update.js", "JavaScript", -7, 0, 0, 0, 0, -11, -4, -22
"c:\Users\rfrjo\pothole-detection-website\.next\static\webpack\app\layout.fbe925cde8eeb7dc.hot-update.js", "JavaScript", -7, 0, 0, 0, 0, -11, -4, -22
"c:\Users\rfrjo\pothole-detection-website\.next\static\webpack\app\layout.fc51d71f73067d3f.hot-update.js", "JavaScript", -7, 0, 0, 0, 0, -11, -4, -22
"c:\Users\rfrjo\pothole-detection-website\.next\static\webpack\app\layout.fe049f32ee0f38ef.hot-update.js", "JavaScript", 7, 0, 0, 0, 0, 11, 4, 22
"c:\Users\rfrjo\pothole-detection-website\.next\static\webpack\app\layout.ffb54dfc8e5706f9.hot-update.js", "JavaScript", -7, 0, 0, 0, 0, -11, -4, -22
"c:\Users\rfrjo\pothole-detection-website\.next\static\webpack\app\maps\page.15533c9ad4427e70.hot-update.js", "JavaScript", -7, 0, 0, 0, 0, -11, -4, -22
"c:\Users\rfrjo\pothole-detection-website\.next\static\webpack\app\maps\page.1e178d13d373339b.hot-update.js", "JavaScript", -7, 0, 0, 0, 0, -11, -4, -22
"c:\Users\rfrjo\pothole-detection-website\.next\static\webpack\app\maps\page.1f9d5f14b6b613da.hot-update.js", "JavaScript", -11, 0, 0, 0, 0, -14, -7, -32
"c:\Users\rfrjo\pothole-detection-website\.next\static\webpack\app\maps\page.2f8ca1b723b8efb7.hot-update.js", "JavaScript", -7, 0, 0, 0, 0, -11, -4, -22
"c:\Users\rfrjo\pothole-detection-website\.next\static\webpack\app\maps\page.36277ac7fedd49ae.hot-update.js", "JavaScript", -7, 0, 0, 0, 0, -11, -4, -22
"c:\Users\rfrjo\pothole-detection-website\.next\static\webpack\app\maps\page.36ecf676eed32104.hot-update.js", "JavaScript", -7, 0, 0, 0, 0, -11, -4, -22
"c:\Users\rfrjo\pothole-detection-website\.next\static\webpack\app\maps\page.382141e07fdcde74.hot-update.js", "JavaScript", -301, 0, 0, 0, 0, -188, -181, -670
"c:\Users\rfrjo\pothole-detection-website\.next\static\webpack\app\maps\page.3ceff98b83edd5ba.hot-update.js", "JavaScript", -7, 0, 0, 0, 0, -11, -4, -22
"c:\Users\rfrjo\pothole-detection-website\.next\static\webpack\app\maps\page.40295ba76eb93afd.hot-update.js", "JavaScript", -7, 0, 0, 0, 0, -11, -4, -22
"c:\Users\rfrjo\pothole-detection-website\.next\static\webpack\app\maps\page.44288f0073fcc4b9.hot-update.js", "JavaScript", -7, 0, 0, 0, 0, -11, -4, -22
"c:\Users\rfrjo\pothole-detection-website\.next\static\webpack\app\maps\page.4df61bd6841d5eac.hot-update.js", "JavaScript", -7, 0, 0, 0, 0, -11, -4, -22
"c:\Users\rfrjo\pothole-detection-website\.next\static\webpack\app\maps\page.53e51f86ef56df26.hot-update.js", "JavaScript", -7, 0, 0, 0, 0, -11, -4, -22
"c:\Users\rfrjo\pothole-detection-website\.next\static\webpack\app\maps\page.54f6af229006dffa.hot-update.js", "JavaScript", -7, 0, 0, 0, 0, -11, -4, -22
"c:\Users\rfrjo\pothole-detection-website\.next\static\webpack\app\maps\page.59bfc2d9eba83495.hot-update.js", "JavaScript", -7, 0, 0, 0, 0, -11, -4, -22
"c:\Users\rfrjo\pothole-detection-website\.next\static\webpack\app\maps\page.5a3d1bcfab1dc770.hot-update.js", "JavaScript", -7, 0, 0, 0, 0, -11, -4, -22
"c:\Users\rfrjo\pothole-detection-website\.next\static\webpack\app\maps\page.6526ad0581466889.hot-update.js", "JavaScript", -7, 0, 0, 0, 0, -11, -4, -22
"c:\Users\rfrjo\pothole-detection-website\.next\static\webpack\app\maps\page.6e00b59ed9168a3b.hot-update.js", "JavaScript", -7, 0, 0, 0, 0, -11, -4, -22
"c:\Users\rfrjo\pothole-detection-website\.next\static\webpack\app\maps\page.705b809a0da72e0a.hot-update.js", "JavaScript", -7, 0, 0, 0, 0, -11, -4, -22
"c:\Users\rfrjo\pothole-detection-website\.next\static\webpack\app\maps\page.71b4169a9c09d80b.hot-update.js", "JavaScript", -7, 0, 0, 0, 0, -11, -4, -22
"c:\Users\rfrjo\pothole-detection-website\.next\static\webpack\app\maps\page.78b9918761b7ec60.hot-update.js", "JavaScript", -7, 0, 0, 0, 0, -11, -4, -22
"c:\Users\rfrjo\pothole-detection-website\.next\static\webpack\app\maps\page.7e20b43409008cc0.hot-update.js", "JavaScript", -7, 0, 0, 0, 0, -11, -4, -22
"c:\Users\rfrjo\pothole-detection-website\.next\static\webpack\app\maps\page.836403eb24b7ffbd.hot-update.js", "JavaScript", -7, 0, 0, 0, 0, -11, -4, -22
"c:\Users\rfrjo\pothole-detection-website\.next\static\webpack\app\maps\page.87eae4974001cebd.hot-update.js", "JavaScript", -7, 0, 0, 0, 0, -11, -4, -22
"c:\Users\rfrjo\pothole-detection-website\.next\static\webpack\app\maps\page.8cfc7e3849acd858.hot-update.js", "JavaScript", -7, 0, 0, 0, 0, -11, -4, -22
"c:\Users\rfrjo\pothole-detection-website\.next\static\webpack\app\maps\page.90045a25807a574e.hot-update.js", "JavaScript", -7, 0, 0, 0, 0, -11, -4, -22
"c:\Users\rfrjo\pothole-detection-website\.next\static\webpack\app\maps\page.972e47f8fdb1b92a.hot-update.js", "JavaScript", -7, 0, 0, 0, 0, -11, -4, -22
"c:\Users\rfrjo\pothole-detection-website\.next\static\webpack\app\maps\page.9ab20fa73369eec1.hot-update.js", "JavaScript", -7, 0, 0, 0, 0, -11, -4, -22
"c:\Users\rfrjo\pothole-detection-website\.next\static\webpack\app\maps\page.9da82ad33978809b.hot-update.js", "JavaScript", -7, 0, 0, 0, 0, -11, -4, -22
"c:\Users\rfrjo\pothole-detection-website\.next\static\webpack\app\maps\page.a2a68842df227705.hot-update.js", "JavaScript", -7, 0, 0, 0, 0, -11, -4, -22
"c:\Users\rfrjo\pothole-detection-website\.next\static\webpack\app\maps\page.a63f32a84bd50758.hot-update.js", "JavaScript", -7, 0, 0, 0, 0, -11, -4, -22
"c:\Users\rfrjo\pothole-detection-website\.next\static\webpack\app\maps\page.a6f20656ebead5cb.hot-update.js", "JavaScript", -7, 0, 0, 0, 0, -11, -4, -22
"c:\Users\rfrjo\pothole-detection-website\.next\static\webpack\app\maps\page.a83439c9a62dd260.hot-update.js", "JavaScript", -11, 0, 0, 0, 0, -14, -7, -32
"c:\Users\rfrjo\pothole-detection-website\.next\static\webpack\app\maps\page.ac63d61331c9c256.hot-update.js", "JavaScript", -7, 0, 0, 0, 0, -11, -4, -22
"c:\Users\rfrjo\pothole-detection-website\.next\static\webpack\app\maps\page.b00e9254685beba5.hot-update.js", "JavaScript", -7, 0, 0, 0, 0, -11, -4, -22
"c:\Users\rfrjo\pothole-detection-website\.next\static\webpack\app\maps\page.b356f9349f46c05f.hot-update.js", "JavaScript", -11, 0, 0, 0, 0, -14, -7, -32
"c:\Users\rfrjo\pothole-detection-website\.next\static\webpack\app\maps\page.ca06906c618b58c0.hot-update.js", "JavaScript", -7, 0, 0, 0, 0, -11, -4, -22
"c:\Users\rfrjo\pothole-detection-website\.next\static\webpack\app\maps\page.cc804bd8b794cc35.hot-update.js", "JavaScript", -7, 0, 0, 0, 0, -11, -4, -22
"c:\Users\rfrjo\pothole-detection-website\.next\static\webpack\app\maps\page.cc9db873835968af.hot-update.js", "JavaScript", -7, 0, 0, 0, 0, -11, -4, -22
"c:\Users\rfrjo\pothole-detection-website\.next\static\webpack\app\maps\page.cd8b500c9d524f82.hot-update.js", "JavaScript", -7, 0, 0, 0, 0, -11, -4, -22
"c:\Users\rfrjo\pothole-detection-website\.next\static\webpack\app\maps\page.d0e21abc3f17e927.hot-update.js", "JavaScript", -7, 0, 0, 0, 0, -11, -4, -22
"c:\Users\rfrjo\pothole-detection-website\.next\static\webpack\app\maps\page.dd156bdb1fdaed17.hot-update.js", "JavaScript", -7, 0, 0, 0, 0, -11, -4, -22
"c:\Users\rfrjo\pothole-detection-website\.next\static\webpack\app\maps\page.e90067ef8ce6181d.hot-update.js", "JavaScript", -7, 0, 0, 0, 0, -11, -4, -22
"c:\Users\rfrjo\pothole-detection-website\.next\static\webpack\app\maps\page.eea850992acc70bf.hot-update.js", "JavaScript", -11, 0, 0, 0, 0, -14, -7, -32
"c:\Users\rfrjo\pothole-detection-website\.next\static\webpack\app\maps\page.ef06e8bcc4d5cc20.hot-update.js", "JavaScript", -7, 0, 0, 0, 0, -11, -4, -22
"c:\Users\rfrjo\pothole-detection-website\.next\static\webpack\app\maps\page.f08265c37c969fb9.hot-update.js", "JavaScript", -7, 0, 0, 0, 0, -11, -4, -22
"c:\Users\rfrjo\pothole-detection-website\.next\static\webpack\app\maps\page.fbe4fd7e0754fbdb.hot-update.js", "JavaScript", -7, 0, 0, 0, 0, -11, -4, -22
"c:\Users\rfrjo\pothole-detection-website\.next\static\webpack\app\maps\page.fc51d71f73067d3f.hot-update.js", "JavaScript", -7, 0, 0, 0, 0, -11, -4, -22
"c:\Users\rfrjo\pothole-detection-website\.next\static\webpack\app\model\page.09f2854a07611b91.hot-update.js", "JavaScript", 7, 0, 0, 0, 0, 11, 4, 22
"c:\Users\rfrjo\pothole-detection-website\.next\static\webpack\app\model\page.15533c9ad4427e70.hot-update.js", "JavaScript", -7, 0, 0, 0, 0, -11, -4, -22
"c:\Users\rfrjo\pothole-detection-website\.next\static\webpack\app\model\page.1e178d13d373339b.hot-update.js", "JavaScript", -7, 0, 0, 0, 0, -11, -4, -22
"c:\Users\rfrjo\pothole-detection-website\.next\static\webpack\app\model\page.1f834d24ad74b4f6.hot-update.js", "JavaScript", 7, 0, 0, 0, 0, 11, 4, 22
"c:\Users\rfrjo\pothole-detection-website\.next\static\webpack\app\model\page.1f9d5f14b6b613da.hot-update.js", "JavaScript", -11, 0, 0, 0, 0, -14, -7, -32
"c:\Users\rfrjo\pothole-detection-website\.next\static\webpack\app\model\page.25e2634e463d29f1.hot-update.js", "JavaScript", -7, 0, 0, 0, 0, -11, -4, -22
"c:\Users\rfrjo\pothole-detection-website\.next\static\webpack\app\model\page.2f8ca1b723b8efb7.hot-update.js", "JavaScript", -7, 0, 0, 0, 0, -11, -4, -22
"c:\Users\rfrjo\pothole-detection-website\.next\static\webpack\app\model\page.35bbf55acd2f0777.hot-update.js", "JavaScript", -326, 0, 0, 0, 0, -203, -196, -725
"c:\Users\rfrjo\pothole-detection-website\.next\static\webpack\app\model\page.36277ac7fedd49ae.hot-update.js", "JavaScript", -7, 0, 0, 0, 0, -11, -4, -22
"c:\Users\rfrjo\pothole-detection-website\.next\static\webpack\app\model\page.36ecf676eed32104.hot-update.js", "JavaScript", -7, 0, 0, 0, 0, -11, -4, -22
"c:\Users\rfrjo\pothole-detection-website\.next\static\webpack\app\model\page.3ceff98b83edd5ba.hot-update.js", "JavaScript", -7, 0, 0, 0, 0, -11, -4, -22
"c:\Users\rfrjo\pothole-detection-website\.next\static\webpack\app\model\page.40295ba76eb93afd.hot-update.js", "JavaScript", -7, 0, 0, 0, 0, -11, -4, -22
"c:\Users\rfrjo\pothole-detection-website\.next\static\webpack\app\model\page.44288f0073fcc4b9.hot-update.js", "JavaScript", -7, 0, 0, 0, 0, -11, -4, -22
"c:\Users\rfrjo\pothole-detection-website\.next\static\webpack\app\model\page.478146370f32c537.hot-update.js", "JavaScript", -7, 0, 0, 0, 0, -11, -4, -22
"c:\Users\rfrjo\pothole-detection-website\.next\static\webpack\app\model\page.499d0255c918291e.hot-update.js", "JavaScript", -7, 0, 0, 0, 0, -11, -4, -22
"c:\Users\rfrjo\pothole-detection-website\.next\static\webpack\app\model\page.4df61bd6841d5eac.hot-update.js", "JavaScript", -7, 0, 0, 0, 0, -11, -4, -22
"c:\Users\rfrjo\pothole-detection-website\.next\static\webpack\app\model\page.53e51f86ef56df26.hot-update.js", "JavaScript", -7, 0, 0, 0, 0, -11, -4, -22
"c:\Users\rfrjo\pothole-detection-website\.next\static\webpack\app\model\page.54f6af229006dffa.hot-update.js", "JavaScript", -7, 0, 0, 0, 0, -11, -4, -22
"c:\Users\rfrjo\pothole-detection-website\.next\static\webpack\app\model\page.59bfc2d9eba83495.hot-update.js", "JavaScript", -7, 0, 0, 0, 0, -11, -4, -22
"c:\Users\rfrjo\pothole-detection-website\.next\static\webpack\app\model\page.5a3d1bcfab1dc770.hot-update.js", "JavaScript", -7, 0, 0, 0, 0, -11, -4, -22
"c:\Users\rfrjo\pothole-detection-website\.next\static\webpack\app\model\page.6526ad0581466889.hot-update.js", "JavaScript", -7, 0, 0, 0, 0, -11, -4, -22
"c:\Users\rfrjo\pothole-detection-website\.next\static\webpack\app\model\page.6e00b59ed9168a3b.hot-update.js", "JavaScript", -7, 0, 0, 0, 0, -11, -4, -22
"c:\Users\rfrjo\pothole-detection-website\.next\static\webpack\app\model\page.705b809a0da72e0a.hot-update.js", "JavaScript", -7, 0, 0, 0, 0, -11, -4, -22
"c:\Users\rfrjo\pothole-detection-website\.next\static\webpack\app\model\page.7117d69c4d8dd1f0.hot-update.js", "JavaScript", -7, 0, 0, 0, 0, -11, -4, -22
"c:\Users\rfrjo\pothole-detection-website\.next\static\webpack\app\model\page.71b4169a9c09d80b.hot-update.js", "JavaScript", -7, 0, 0, 0, 0, -11, -4, -22
"c:\Users\rfrjo\pothole-detection-website\.next\static\webpack\app\model\page.78b9918761b7ec60.hot-update.js", "JavaScript", -7, 0, 0, 0, 0, -11, -4, -22
"c:\Users\rfrjo\pothole-detection-website\.next\static\webpack\app\model\page.7e20b43409008cc0.hot-update.js", "JavaScript", -7, 0, 0, 0, 0, -11, -4, -22
"c:\Users\rfrjo\pothole-detection-website\.next\static\webpack\app\model\page.836403eb24b7ffbd.hot-update.js", "JavaScript", -7, 0, 0, 0, 0, -11, -4, -22
"c:\Users\rfrjo\pothole-detection-website\.next\static\webpack\app\model\page.87eae4974001cebd.hot-update.js", "JavaScript", -7, 0, 0, 0, 0, -11, -4, -22
"c:\Users\rfrjo\pothole-detection-website\.next\static\webpack\app\model\page.8cfc7e3849acd858.hot-update.js", "JavaScript", -7, 0, 0, 0, 0, -11, -4, -22
"c:\Users\rfrjo\pothole-detection-website\.next\static\webpack\app\model\page.90045a25807a574e.hot-update.js", "JavaScript", -7, 0, 0, 0, 0, -11, -4, -22
"c:\Users\rfrjo\pothole-detection-website\.next\static\webpack\app\model\page.949edd130e0d8b15.hot-update.js", "JavaScript", 7, 0, 0, 0, 0, 11, 4, 22
"c:\Users\rfrjo\pothole-detection-website\.next\static\webpack\app\model\page.972e47f8fdb1b92a.hot-update.js", "JavaScript", -7, 0, 0, 0, 0, -11, -4, -22
"c:\Users\rfrjo\pothole-detection-website\.next\static\webpack\app\model\page.9ab20fa73369eec1.hot-update.js", "JavaScript", -7, 0, 0, 0, 0, -11, -4, -22
"c:\Users\rfrjo\pothole-detection-website\.next\static\webpack\app\model\page.9da82ad33978809b.hot-update.js", "JavaScript", -7, 0, 0, 0, 0, -11, -4, -22
"c:\Users\rfrjo\pothole-detection-website\.next\static\webpack\app\model\page.a2a68842df227705.hot-update.js", "JavaScript", -7, 0, 0, 0, 0, -11, -4, -22
"c:\Users\rfrjo\pothole-detection-website\.next\static\webpack\app\model\page.a63f32a84bd50758.hot-update.js", "JavaScript", -7, 0, 0, 0, 0, -11, -4, -22
"c:\Users\rfrjo\pothole-detection-website\.next\static\webpack\app\model\page.a6f20656ebead5cb.hot-update.js", "JavaScript", -7, 0, 0, 0, 0, -11, -4, -22
"c:\Users\rfrjo\pothole-detection-website\.next\static\webpack\app\model\page.a83439c9a62dd260.hot-update.js", "JavaScript", -11, 0, 0, 0, 0, -14, -7, -32
"c:\Users\rfrjo\pothole-detection-website\.next\static\webpack\app\model\page.a88718d08d250638.hot-update.js", "JavaScript", 7, 0, 0, 0, 0, 11, 4, 22
"c:\Users\rfrjo\pothole-detection-website\.next\static\webpack\app\model\page.ac63d61331c9c256.hot-update.js", "JavaScript", -7, 0, 0, 0, 0, -11, -4, -22
"c:\Users\rfrjo\pothole-detection-website\.next\static\webpack\app\model\page.b00e9254685beba5.hot-update.js", "JavaScript", -7, 0, 0, 0, 0, -11, -4, -22
"c:\Users\rfrjo\pothole-detection-website\.next\static\webpack\app\model\page.b356f9349f46c05f.hot-update.js", "JavaScript", -11, 0, 0, 0, 0, -14, -7, -32
"c:\Users\rfrjo\pothole-detection-website\.next\static\webpack\app\model\page.b4935ee67ccb232c.hot-update.js", "JavaScript", 7, 0, 0, 0, 0, 11, 4, 22
"c:\Users\rfrjo\pothole-detection-website\.next\static\webpack\app\model\page.b724e9efc9d6f974.hot-update.js", "JavaScript", -7, 0, 0, 0, 0, -11, -4, -22
"c:\Users\rfrjo\pothole-detection-website\.next\static\webpack\app\model\page.c7ebeba584f48140.hot-update.js", "JavaScript", -7, 0, 0, 0, 0, -11, -4, -22
"c:\Users\rfrjo\pothole-detection-website\.next\static\webpack\app\model\page.ca06906c618b58c0.hot-update.js", "JavaScript", -7, 0, 0, 0, 0, -11, -4, -22
"c:\Users\rfrjo\pothole-detection-website\.next\static\webpack\app\model\page.cc804bd8b794cc35.hot-update.js", "JavaScript", -7, 0, 0, 0, 0, -11, -4, -22
"c:\Users\rfrjo\pothole-detection-website\.next\static\webpack\app\model\page.cc9db873835968af.hot-update.js", "JavaScript", -7, 0, 0, 0, 0, -11, -4, -22
"c:\Users\rfrjo\pothole-detection-website\.next\static\webpack\app\model\page.cd8b500c9d524f82.hot-update.js", "JavaScript", -7, 0, 0, 0, 0, -11, -4, -22
"c:\Users\rfrjo\pothole-detection-website\.next\static\webpack\app\model\page.d0e21abc3f17e927.hot-update.js", "JavaScript", -7, 0, 0, 0, 0, -11, -4, -22
"c:\Users\rfrjo\pothole-detection-website\.next\static\webpack\app\model\page.da6ee9ed3accfd7c.hot-update.js", "JavaScript", -7, 0, 0, 0, 0, -11, -4, -22
"c:\Users\rfrjo\pothole-detection-website\.next\static\webpack\app\model\page.dd156bdb1fdaed17.hot-update.js", "JavaScript", -7, 0, 0, 0, 0, -11, -4, -22
"c:\Users\rfrjo\pothole-detection-website\.next\static\webpack\app\model\page.e90067ef8ce6181d.hot-update.js", "JavaScript", -7, 0, 0, 0, 0, -11, -4, -22
"c:\Users\rfrjo\pothole-detection-website\.next\static\webpack\app\model\page.eea850992acc70bf.hot-update.js", "JavaScript", -11, 0, 0, 0, 0, -14, -7, -32
"c:\Users\rfrjo\pothole-detection-website\.next\static\webpack\app\model\page.ef06e8bcc4d5cc20.hot-update.js", "JavaScript", -7, 0, 0, 0, 0, -11, -4, -22
"c:\Users\rfrjo\pothole-detection-website\.next\static\webpack\app\model\page.f08265c37c969fb9.hot-update.js", "JavaScript", -7, 0, 0, 0, 0, -11, -4, -22
"c:\Users\rfrjo\pothole-detection-website\.next\static\webpack\app\model\page.fbe4fd7e0754fbdb.hot-update.js", "JavaScript", -7, 0, 0, 0, 0, -11, -4, -22
"c:\Users\rfrjo\pothole-detection-website\.next\static\webpack\app\model\page.fc51d71f73067d3f.hot-update.js", "JavaScript", -7, 0, 0, 0, 0, -11, -4, -22
"c:\Users\rfrjo\pothole-detection-website\.next\static\webpack\app\page.1019e17dc34f90f7.hot-update.js", "JavaScript", -7, 0, 0, 0, 0, -11, -4, -22
"c:\Users\rfrjo\pothole-detection-website\.next\static\webpack\app\page.1c32acae818838c2.hot-update.js", "JavaScript", -15, 0, 0, 0, 0, -17, -10, -42
"c:\Users\rfrjo\pothole-detection-website\.next\static\webpack\app\page.3075e1cd05d6febe.hot-update.js", "JavaScript", -56, 0, 0, 0, 0, -41, -34, -131
"c:\Users\rfrjo\pothole-detection-website\.next\static\webpack\app\page.59f4dd90ac1f2a7b.hot-update.js", "JavaScript", -7, 0, 0, 0, 0, -11, -4, -22
"c:\Users\rfrjo\pothole-detection-website\.next\static\webpack\app\page.5c91122845ef46d4.hot-update.js", "JavaScript", -7, 0, 0, 0, 0, -11, -4, -22
"c:\Users\rfrjo\pothole-detection-website\.next\static\webpack\app\page.63971713ced1858f.hot-update.js", "JavaScript", -71, 0, 0, 0, 0, -59, -52, -182
"c:\Users\rfrjo\pothole-detection-website\.next\static\webpack\app\page.6542ad685ec8b80d.hot-update.js", "JavaScript", -23, 0, 0, 0, 0, -23, -16, -62
"c:\Users\rfrjo\pothole-detection-website\.next\static\webpack\app\page.863a15ead088bba9.hot-update.js", "JavaScript", -7, 0, 0, 0, 0, -11, -4, -22
"c:\Users\rfrjo\pothole-detection-website\.next\static\webpack\app\page.9ad0b9331bbdf1ef.hot-update.js", "JavaScript", -7, 0, 0, 0, 0, -11, -4, -22
"c:\Users\rfrjo\pothole-detection-website\.next\static\webpack\app\page.b33251ce981b4e64.hot-update.js", "JavaScript", -11, 0, 0, 0, 0, -14, -7, -32
"c:\Users\rfrjo\pothole-detection-website\.next\static\webpack\app\page.d3f9d5d6accb4bbb.hot-update.js", "JavaScript", 41, 0, 0, 0, 0, 32, 25, 98
"c:\Users\rfrjo\pothole-detection-website\.next\static\webpack\app\page.d4cfa901868645e2.hot-update.js", "JavaScript", 7, 0, 0, 0, 0, 11, 4, 22
"c:\Users\rfrjo\pothole-detection-website\.next\static\webpack\app\signin\page.1c32acae818838c2.hot-update.js", "JavaScript", -15, 0, 0, 0, 0, -17, -10, -42
"c:\Users\rfrjo\pothole-detection-website\.next\static\webpack\app\signin\page.1eaa88a0999b1364.hot-update.js", "JavaScript", -27, 0, 0, 0, 0, -26, -19, -72
"c:\Users\rfrjo\pothole-detection-website\.next\static\webpack\app\signin\page.3075e1cd05d6febe.hot-update.js", "JavaScript", -56, 0, 0, 0, 0, -41, -34, -131
"c:\Users\rfrjo\pothole-detection-website\.next\static\webpack\app\signin\page.536a639bf7e5e9f4.hot-update.js", "JavaScript", -7, 0, 0, 0, 0, -11, -4, -22
"c:\Users\rfrjo\pothole-detection-website\.next\static\webpack\app\signin\page.6542ad685ec8b80d.hot-update.js", "JavaScript", -23, 0, 0, 0, 0, -23, -16, -62
"c:\Users\rfrjo\pothole-detection-website\.next\static\webpack\app\signin\page.9ad0b9331bbdf1ef.hot-update.js", "JavaScript", -7, 0, 0, 0, 0, -11, -4, -22
"c:\Users\rfrjo\pothole-detection-website\.next\static\webpack\app\signin\page.ae005569fba7523e.hot-update.js", "JavaScript", -7, 0, 0, 0, 0, -11, -4, -22
"c:\Users\rfrjo\pothole-detection-website\.next\static\webpack\app\signin\page.b33251ce981b4e64.hot-update.js", "JavaScript", -91, 0, 0, 0, 0, -74, -67, -232
"c:\Users\rfrjo\pothole-detection-website\.next\static\webpack\app\signin\page.d3f9d5d6accb4bbb.hot-update.js", "JavaScript", 41, 0, 0, 0, 0, 32, 25, 98
"c:\Users\rfrjo\pothole-detection-website\.next\static\webpack\app\signin\page.d4cfa901868645e2.hot-update.js", "JavaScript", 7, 0, 0, 0, 0, 11, 4, 22
"c:\Users\rfrjo\pothole-detection-website\.next\static\webpack\app\signin\page.d9a2c09833ac5b84.hot-update.js", "JavaScript", -7, 0, 0, 0, 0, -11, -4, -22
"c:\Users\rfrjo\pothole-detection-website\.next\static\webpack\app\signin\page.da189dca28b2fd71.hot-update.js", "JavaScript", -139, 0, 0, 0, 0, -110, -103, -352
"c:\Users\rfrjo\pothole-detection-website\.next\static\webpack\app\signup\page.1c32acae818838c2.hot-update.js", "JavaScript", -15, 0, 0, 0, 0, -17, -10, -42
"c:\Users\rfrjo\pothole-detection-website\.next\static\webpack\app\signup\page.1eaa88a0999b1364.hot-update.js", "JavaScript", -27, 0, 0, 0, 0, -26, -19, -72
"c:\Users\rfrjo\pothole-detection-website\.next\static\webpack\app\signup\page.23a5b02801af775d.hot-update.js", "JavaScript", -7, 0, 0, 0, 0, -11, -4, -22
"c:\Users\rfrjo\pothole-detection-website\.next\static\webpack\app\signup\page.3075e1cd05d6febe.hot-update.js", "JavaScript", -56, 0, 0, 0, 0, -41, -34, -131
"c:\Users\rfrjo\pothole-detection-website\.next\static\webpack\app\signup\page.35543311e684b41b.hot-update.js", "JavaScript", -7, 0, 0, 0, 0, -11, -4, -22
"c:\Users\rfrjo\pothole-detection-website\.next\static\webpack\app\signup\page.3fd574372d51d356.hot-update.js", "JavaScript", -87, 0, 0, 0, 0, -71, -64, -222
"c:\Users\rfrjo\pothole-detection-website\.next\static\webpack\app\signup\page.5ab59c38990547bb.hot-update.js", "JavaScript", -7, 0, 0, 0, 0, -11, -4, -22
"c:\Users\rfrjo\pothole-detection-website\.next\static\webpack\app\signup\page.6542ad685ec8b80d.hot-update.js", "JavaScript", -23, 0, 0, 0, 0, -23, -16, -62
"c:\Users\rfrjo\pothole-detection-website\.next\static\webpack\app\signup\page.6f4e069acbdb7f44.hot-update.js", "JavaScript", -7, 0, 0, 0, 0, -11, -4, -22
"c:\Users\rfrjo\pothole-detection-website\.next\static\webpack\app\signup\page.718317dae5cd0fbb.hot-update.js", "JavaScript", -7, 0, 0, 0, 0, -11, -4, -22
"c:\Users\rfrjo\pothole-detection-website\.next\static\webpack\app\signup\page.76d95935b394a037.hot-update.js", "JavaScript", -7, 0, 0, 0, 0, -11, -4, -22
"c:\Users\rfrjo\pothole-detection-website\.next\static\webpack\app\signup\page.80818ec3b62912ab.hot-update.js", "JavaScript", -7, 0, 0, 0, 0, -11, -4, -22
"c:\Users\rfrjo\pothole-detection-website\.next\static\webpack\app\signup\page.9ad0b9331bbdf1ef.hot-update.js", "JavaScript", -7, 0, 0, 0, 0, -11, -4, -22
"c:\Users\rfrjo\pothole-detection-website\.next\static\webpack\app\signup\page.b33251ce981b4e64.hot-update.js", "JavaScript", -7, 0, 0, 0, 0, -11, -4, -22
"c:\Users\rfrjo\pothole-detection-website\.next\static\webpack\app\signup\page.d9a2c09833ac5b84.hot-update.js", "JavaScript", -7, 0, 0, 0, 0, -11, -4, -22
"c:\Users\rfrjo\pothole-detection-website\.next\static\webpack\app\signup\page.e10874c4bc226ea0.hot-update.js", "JavaScript", -7, 0, 0, 0, 0, -11, -4, -22
"c:\Users\rfrjo\pothole-detection-website\.next\static\webpack\app\spreadsheets\page.03f416adaa618df1.hot-update.js", "JavaScript", 271, 0, 0, 0, 0, 209, 202, 682
"c:\Users\rfrjo\pothole-detection-website\.next\static\webpack\app\spreadsheets\page.09f2854a07611b91.hot-update.js", "JavaScript", 7, 0, 0, 0, 0, 11, 4, 22
"c:\Users\rfrjo\pothole-detection-website\.next\static\webpack\app\spreadsheets\page.0f59587d0a6f5dd0.hot-update.js", "JavaScript", 7, 0, 0, 0, 0, 11, 4, 22
"c:\Users\rfrjo\pothole-detection-website\.next\static\webpack\app\spreadsheets\page.15533c9ad4427e70.hot-update.js", "JavaScript", -7, 0, 0, 0, 0, -11, -4, -22
"c:\Users\rfrjo\pothole-detection-website\.next\static\webpack\app\spreadsheets\page.1e178d13d373339b.hot-update.js", "JavaScript", -7, 0, 0, 0, 0, -11, -4, -22
"c:\Users\rfrjo\pothole-detection-website\.next\static\webpack\app\spreadsheets\page.1f834d24ad74b4f6.hot-update.js", "JavaScript", 7, 0, 0, 0, 0, 11, 4, 22
"c:\Users\rfrjo\pothole-detection-website\.next\static\webpack\app\spreadsheets\page.1f9d5f14b6b613da.hot-update.js", "JavaScript", -11, 0, 0, 0, 0, -14, -7, -32
"c:\Users\rfrjo\pothole-detection-website\.next\static\webpack\app\spreadsheets\page.2af20e4231425d85.hot-update.js", "JavaScript", 11, 0, 0, 0, 0, 14, 7, 32
"c:\Users\rfrjo\pothole-detection-website\.next\static\webpack\app\spreadsheets\page.2f8ca1b723b8efb7.hot-update.js", "JavaScript", -7, 0, 0, 0, 0, -11, -4, -22
"c:\Users\rfrjo\pothole-detection-website\.next\static\webpack\app\spreadsheets\page.36277ac7fedd49ae.hot-update.js", "JavaScript", -7, 0, 0, 0, 0, -11, -4, -22
"c:\Users\rfrjo\pothole-detection-website\.next\static\webpack\app\spreadsheets\page.36ecf676eed32104.hot-update.js", "JavaScript", -7, 0, 0, 0, 0, -11, -4, -22
"c:\Users\rfrjo\pothole-detection-website\.next\static\webpack\app\spreadsheets\page.3ceff98b83edd5ba.hot-update.js", "JavaScript", -7, 0, 0, 0, 0, -11, -4, -22
"c:\Users\rfrjo\pothole-detection-website\.next\static\webpack\app\spreadsheets\page.40295ba76eb93afd.hot-update.js", "JavaScript", -7, 0, 0, 0, 0, -11, -4, -22
"c:\Users\rfrjo\pothole-detection-website\.next\static\webpack\app\spreadsheets\page.44288f0073fcc4b9.hot-update.js", "JavaScript", -7, 0, 0, 0, 0, -11, -4, -22
"c:\Users\rfrjo\pothole-detection-website\.next\static\webpack\app\spreadsheets\page.4df61bd6841d5eac.hot-update.js", "JavaScript", -7, 0, 0, 0, 0, -11, -4, -22
"c:\Users\rfrjo\pothole-detection-website\.next\static\webpack\app\spreadsheets\page.53e51f86ef56df26.hot-update.js", "JavaScript", -7, 0, 0, 0, 0, -11, -4, -22
"c:\Users\rfrjo\pothole-detection-website\.next\static\webpack\app\spreadsheets\page.54f6af229006dffa.hot-update.js", "JavaScript", -7, 0, 0, 0, 0, -11, -4, -22
"c:\Users\rfrjo\pothole-detection-website\.next\static\webpack\app\spreadsheets\page.59bfc2d9eba83495.hot-update.js", "JavaScript", -7, 0, 0, 0, 0, -11, -4, -22
"c:\Users\rfrjo\pothole-detection-website\.next\static\webpack\app\spreadsheets\page.5a3d1bcfab1dc770.hot-update.js", "JavaScript", -7, 0, 0, 0, 0, -11, -4, -22
"c:\Users\rfrjo\pothole-detection-website\.next\static\webpack\app\spreadsheets\page.6526ad0581466889.hot-update.js", "JavaScript", -7, 0, 0, 0, 0, -11, -4, -22
"c:\Users\rfrjo\pothole-detection-website\.next\static\webpack\app\spreadsheets\page.6e00b59ed9168a3b.hot-update.js", "JavaScript", -7, 0, 0, 0, 0, -11, -4, -22
"c:\Users\rfrjo\pothole-detection-website\.next\static\webpack\app\spreadsheets\page.705b809a0da72e0a.hot-update.js", "JavaScript", -7, 0, 0, 0, 0, -11, -4, -22
"c:\Users\rfrjo\pothole-detection-website\.next\static\webpack\app\spreadsheets\page.71b4169a9c09d80b.hot-update.js", "JavaScript", -7, 0, 0, 0, 0, -11, -4, -22
"c:\Users\rfrjo\pothole-detection-website\.next\static\webpack\app\spreadsheets\page.72539884909e2f51.hot-update.js", "JavaScript", -296, 0, 0, 0, 0, -185, -178, -659
"c:\Users\rfrjo\pothole-detection-website\.next\static\webpack\app\spreadsheets\page.78b9918761b7ec60.hot-update.js", "JavaScript", -7, 0, 0, 0, 0, -11, -4, -22
"c:\Users\rfrjo\pothole-detection-website\.next\static\webpack\app\spreadsheets\page.7e20b43409008cc0.hot-update.js", "JavaScript", -7, 0, 0, 0, 0, -11, -4, -22
"c:\Users\rfrjo\pothole-detection-website\.next\static\webpack\app\spreadsheets\page.836403eb24b7ffbd.hot-update.js", "JavaScript", -7, 0, 0, 0, 0, -11, -4, -22
"c:\Users\rfrjo\pothole-detection-website\.next\static\webpack\app\spreadsheets\page.87eae4974001cebd.hot-update.js", "JavaScript", -7, 0, 0, 0, 0, -11, -4, -22
"c:\Users\rfrjo\pothole-detection-website\.next\static\webpack\app\spreadsheets\page.8cfc7e3849acd858.hot-update.js", "JavaScript", -7, 0, 0, 0, 0, -11, -4, -22
"c:\Users\rfrjo\pothole-detection-website\.next\static\webpack\app\spreadsheets\page.90045a25807a574e.hot-update.js", "JavaScript", -7, 0, 0, 0, 0, -11, -4, -22
"c:\Users\rfrjo\pothole-detection-website\.next\static\webpack\app\spreadsheets\page.949edd130e0d8b15.hot-update.js", "JavaScript", 7, 0, 0, 0, 0, 11, 4, 22
"c:\Users\rfrjo\pothole-detection-website\.next\static\webpack\app\spreadsheets\page.972e47f8fdb1b92a.hot-update.js", "JavaScript", -7, 0, 0, 0, 0, -11, -4, -22
"c:\Users\rfrjo\pothole-detection-website\.next\static\webpack\app\spreadsheets\page.9ab20fa73369eec1.hot-update.js", "JavaScript", -7, 0, 0, 0, 0, -11, -4, -22
"c:\Users\rfrjo\pothole-detection-website\.next\static\webpack\app\spreadsheets\page.9da82ad33978809b.hot-update.js", "JavaScript", -7, 0, 0, 0, 0, -11, -4, -22
"c:\Users\rfrjo\pothole-detection-website\.next\static\webpack\app\spreadsheets\page.a2a68842df227705.hot-update.js", "JavaScript", -7, 0, 0, 0, 0, -11, -4, -22
"c:\Users\rfrjo\pothole-detection-website\.next\static\webpack\app\spreadsheets\page.a63f32a84bd50758.hot-update.js", "JavaScript", -7, 0, 0, 0, 0, -11, -4, -22
"c:\Users\rfrjo\pothole-detection-website\.next\static\webpack\app\spreadsheets\page.a6f20656ebead5cb.hot-update.js", "JavaScript", -7, 0, 0, 0, 0, -11, -4, -22
"c:\Users\rfrjo\pothole-detection-website\.next\static\webpack\app\spreadsheets\page.a83439c9a62dd260.hot-update.js", "JavaScript", -11, 0, 0, 0, 0, -14, -7, -32
"c:\Users\rfrjo\pothole-detection-website\.next\static\webpack\app\spreadsheets\page.a88718d08d250638.hot-update.js", "JavaScript", 7, 0, 0, 0, 0, 11, 4, 22
"c:\Users\rfrjo\pothole-detection-website\.next\static\webpack\app\spreadsheets\page.ac63d61331c9c256.hot-update.js", "JavaScript", -7, 0, 0, 0, 0, -11, -4, -22
"c:\Users\rfrjo\pothole-detection-website\.next\static\webpack\app\spreadsheets\page.b00e9254685beba5.hot-update.js", "JavaScript", -7, 0, 0, 0, 0, -11, -4, -22
"c:\Users\rfrjo\pothole-detection-website\.next\static\webpack\app\spreadsheets\page.b356f9349f46c05f.hot-update.js", "JavaScript", -11, 0, 0, 0, 0, -14, -7, -32
"c:\Users\rfrjo\pothole-detection-website\.next\static\webpack\app\spreadsheets\page.b4935ee67ccb232c.hot-update.js", "JavaScript", 7, 0, 0, 0, 0, 11, 4, 22
"c:\Users\rfrjo\pothole-detection-website\.next\static\webpack\app\spreadsheets\page.ca06906c618b58c0.hot-update.js", "JavaScript", -7, 0, 0, 0, 0, -11, -4, -22
"c:\Users\rfrjo\pothole-detection-website\.next\static\webpack\app\spreadsheets\page.cc804bd8b794cc35.hot-update.js", "JavaScript", -7, 0, 0, 0, 0, -11, -4, -22
"c:\Users\rfrjo\pothole-detection-website\.next\static\webpack\app\spreadsheets\page.cc9db873835968af.hot-update.js", "JavaScript", -7, 0, 0, 0, 0, -11, -4, -22
"c:\Users\rfrjo\pothole-detection-website\.next\static\webpack\app\spreadsheets\page.cd8b500c9d524f82.hot-update.js", "JavaScript", -7, 0, 0, 0, 0, -11, -4, -22
"c:\Users\rfrjo\pothole-detection-website\.next\static\webpack\app\spreadsheets\page.d0e21abc3f17e927.hot-update.js", "JavaScript", -7, 0, 0, 0, 0, -11, -4, -22
"c:\Users\rfrjo\pothole-detection-website\.next\static\webpack\app\spreadsheets\page.d3f9d5d6accb4bbb.hot-update.js", "JavaScript", 7, 0, 0, 0, 0, 11, 4, 22
"c:\Users\rfrjo\pothole-detection-website\.next\static\webpack\app\spreadsheets\page.d4cfa901868645e2.hot-update.js", "JavaScript", 239, 0, 0, 0, 0, 185, 178, 602
"c:\Users\rfrjo\pothole-detection-website\.next\static\webpack\app\spreadsheets\page.dd156bdb1fdaed17.hot-update.js", "JavaScript", -7, 0, 0, 0, 0, -11, -4, -22
"c:\Users\rfrjo\pothole-detection-website\.next\static\webpack\app\spreadsheets\page.e90067ef8ce6181d.hot-update.js", "JavaScript", -7, 0, 0, 0, 0, -11, -4, -22
"c:\Users\rfrjo\pothole-detection-website\.next\static\webpack\app\spreadsheets\page.eea850992acc70bf.hot-update.js", "JavaScript", -11, 0, 0, 0, 0, -14, -7, -32
"c:\Users\rfrjo\pothole-detection-website\.next\static\webpack\app\spreadsheets\page.ef06e8bcc4d5cc20.hot-update.js", "JavaScript", -7, 0, 0, 0, 0, -11, -4, -22
"c:\Users\rfrjo\pothole-detection-website\.next\static\webpack\app\spreadsheets\page.f08265c37c969fb9.hot-update.js", "JavaScript", -7, 0, 0, 0, 0, -11, -4, -22
"c:\Users\rfrjo\pothole-detection-website\.next\static\webpack\app\spreadsheets\page.f9c5fb343c296e1c.hot-update.js", "JavaScript", 135, 0, 0, 0, 0, 89, 82, 306
"c:\Users\rfrjo\pothole-detection-website\.next\static\webpack\app\spreadsheets\page.fbe4fd7e0754fbdb.hot-update.js", "JavaScript", -7, 0, 0, 0, 0, -11, -4, -22
"c:\Users\rfrjo\pothole-detection-website\.next\static\webpack\app\spreadsheets\page.fc51d71f73067d3f.hot-update.js", "JavaScript", -7, 0, 0, 0, 0, -11, -4, -22
"c:\Users\rfrjo\pothole-detection-website\.next\static\webpack\app\upload\page.052f6dea2efbf9c3.hot-update.js", "JavaScript", 7, 0, 0, 0, 0, 11, 4, 22
"c:\Users\rfrjo\pothole-detection-website\.next\static\webpack\app\upload\page.09f2854a07611b91.hot-update.js", "JavaScript", 7, 0, 0, 0, 0, 11, 4, 22
"c:\Users\rfrjo\pothole-detection-website\.next\static\webpack\app\upload\page.15533c9ad4427e70.hot-update.js", "JavaScript", -7, 0, 0, 0, 0, -11, -4, -22
"c:\Users\rfrjo\pothole-detection-website\.next\static\webpack\app\upload\page.16a32586d354b631.hot-update.js", "JavaScript", 7, 0, 0, 0, 0, 11, 4, 22
"c:\Users\rfrjo\pothole-detection-website\.next\static\webpack\app\upload\page.1b6b2212351d04eb.hot-update.js", "JavaScript", 7, 0, 0, 0, 0, 11, 4, 22
"c:\Users\rfrjo\pothole-detection-website\.next\static\webpack\app\upload\page.1bf57e9ca108224a.hot-update.js", "JavaScript", 7, 0, 0, 0, 0, 11, 4, 22
"c:\Users\rfrjo\pothole-detection-website\.next\static\webpack\app\upload\page.1e178d13d373339b.hot-update.js", "JavaScript", -7, 0, 0, 0, 0, -11, -4, -22
"c:\Users\rfrjo\pothole-detection-website\.next\static\webpack\app\upload\page.1f834d24ad74b4f6.hot-update.js", "JavaScript", 7, 0, 0, 0, 0, 11, 4, 22
"c:\Users\rfrjo\pothole-detection-website\.next\static\webpack\app\upload\page.1f9d5f14b6b613da.hot-update.js", "JavaScript", -11, 0, 0, 0, 0, -14, -7, -32
"c:\Users\rfrjo\pothole-detection-website\.next\static\webpack\app\upload\page.2437995ad6de6d44.hot-update.js", "JavaScript", 7, 0, 0, 0, 0, 11, 4, 22
"c:\Users\rfrjo\pothole-detection-website\.next\static\webpack\app\upload\page.2447dcefc4d408c0.hot-update.js", "JavaScript", 7, 0, 0, 0, 0, 11, 4, 22
"c:\Users\rfrjo\pothole-detection-website\.next\static\webpack\app\upload\page.27f6d42552c967a9.hot-update.js", "JavaScript", -7, 0, 0, 0, 0, -11, -4, -22
"c:\Users\rfrjo\pothole-detection-website\.next\static\webpack\app\upload\page.2bfff34f33985a5c.hot-update.js", "JavaScript", 7, 0, 0, 0, 0, 11, 4, 22
"c:\Users\rfrjo\pothole-detection-website\.next\static\webpack\app\upload\page.2f8ca1b723b8efb7.hot-update.js", "JavaScript", -7, 0, 0, 0, 0, -11, -4, -22
"c:\Users\rfrjo\pothole-detection-website\.next\static\webpack\app\upload\page.36277ac7fedd49ae.hot-update.js", "JavaScript", -7, 0, 0, 0, 0, -11, -4, -22
"c:\Users\rfrjo\pothole-detection-website\.next\static\webpack\app\upload\page.36ecf676eed32104.hot-update.js", "JavaScript", -7, 0, 0, 0, 0, -11, -4, -22
"c:\Users\rfrjo\pothole-detection-website\.next\static\webpack\app\upload\page.3af8302a34ff3f9b.hot-update.js", "JavaScript", 7, 0, 0, 0, 0, 11, 4, 22
"c:\Users\rfrjo\pothole-detection-website\.next\static\webpack\app\upload\page.3ceff98b83edd5ba.hot-update.js", "JavaScript", -7, 0, 0, 0, 0, -11, -4, -22
"c:\Users\rfrjo\pothole-detection-website\.next\static\webpack\app\upload\page.40295ba76eb93afd.hot-update.js", "JavaScript", -7, 0, 0, 0, 0, -11, -4, -22
"c:\Users\rfrjo\pothole-detection-website\.next\static\webpack\app\upload\page.44288f0073fcc4b9.hot-update.js", "JavaScript", -7, 0, 0, 0, 0, -11, -4, -22
"c:\Users\rfrjo\pothole-detection-website\.next\static\webpack\app\upload\page.4df61bd6841d5eac.hot-update.js", "JavaScript", -7, 0, 0, 0, 0, -11, -4, -22
"c:\Users\rfrjo\pothole-detection-website\.next\static\webpack\app\upload\page.53e51f86ef56df26.hot-update.js", "JavaScript", -7, 0, 0, 0, 0, -11, -4, -22
"c:\Users\rfrjo\pothole-detection-website\.next\static\webpack\app\upload\page.54f6af229006dffa.hot-update.js", "JavaScript", -7, 0, 0, 0, 0, -11, -4, -22
"c:\Users\rfrjo\pothole-detection-website\.next\static\webpack\app\upload\page.599be672b367805b.hot-update.js", "JavaScript", 7, 0, 0, 0, 0, 11, 4, 22
"c:\Users\rfrjo\pothole-detection-website\.next\static\webpack\app\upload\page.59bfc2d9eba83495.hot-update.js", "JavaScript", -7, 0, 0, 0, 0, -11, -4, -22
"c:\Users\rfrjo\pothole-detection-website\.next\static\webpack\app\upload\page.5a3d1bcfab1dc770.hot-update.js", "JavaScript", -7, 0, 0, 0, 0, -11, -4, -22
"c:\Users\rfrjo\pothole-detection-website\.next\static\webpack\app\upload\page.629b8911cc520362.hot-update.js", "JavaScript", -7, 0, 0, 0, 0, -11, -4, -22
"c:\Users\rfrjo\pothole-detection-website\.next\static\webpack\app\upload\page.6526ad0581466889.hot-update.js", "JavaScript", -7, 0, 0, 0, 0, -11, -4, -22
"c:\Users\rfrjo\pothole-detection-website\.next\static\webpack\app\upload\page.6c4c64dd3db346a4.hot-update.js", "JavaScript", -11, 0, 0, 0, 0, -14, -7, -32
"c:\Users\rfrjo\pothole-detection-website\.next\static\webpack\app\upload\page.6e00b59ed9168a3b.hot-update.js", "JavaScript", -7, 0, 0, 0, 0, -11, -4, -22
"c:\Users\rfrjo\pothole-detection-website\.next\static\webpack\app\upload\page.6f49d563ee97279e.hot-update.js", "JavaScript", -11, 0, 0, 0, 0, -14, -7, -32
"c:\Users\rfrjo\pothole-detection-website\.next\static\webpack\app\upload\page.704ada73f32ffcfe.hot-update.js", "JavaScript", 7, 0, 0, 0, 0, 11, 4, 22
"c:\Users\rfrjo\pothole-detection-website\.next\static\webpack\app\upload\page.705b809a0da72e0a.hot-update.js", "JavaScript", -7, 0, 0, 0, 0, -11, -4, -22
"c:\Users\rfrjo\pothole-detection-website\.next\static\webpack\app\upload\page.71b4169a9c09d80b.hot-update.js", "JavaScript", -7, 0, 0, 0, 0, -11, -4, -22
"c:\Users\rfrjo\pothole-detection-website\.next\static\webpack\app\upload\page.72e8be227edd0633.hot-update.js", "JavaScript", 7, 0, 0, 0, 0, 11, 4, 22
"c:\Users\rfrjo\pothole-detection-website\.next\static\webpack\app\upload\page.74bf66b145b7f31a.hot-update.js", "JavaScript", 11, 0, 0, 0, 0, 14, 7, 32
"c:\Users\rfrjo\pothole-detection-website\.next\static\webpack\app\upload\page.7553387ad1cc69a3.hot-update.js", "JavaScript", 7, 0, 0, 0, 0, 11, 4, 22
"c:\Users\rfrjo\pothole-detection-website\.next\static\webpack\app\upload\page.7724e64c228ec499.hot-update.js", "JavaScript", -101, 0, 0, 0, 0, -68, -61, -230
"c:\Users\rfrjo\pothole-detection-website\.next\static\webpack\app\upload\page.78b9918761b7ec60.hot-update.js", "JavaScript", -7, 0, 0, 0, 0, -11, -4, -22
"c:\Users\rfrjo\pothole-detection-website\.next\static\webpack\app\upload\page.7e20b43409008cc0.hot-update.js", "JavaScript", -7, 0, 0, 0, 0, -11, -4, -22
"c:\Users\rfrjo\pothole-detection-website\.next\static\webpack\app\upload\page.82bcae466be0d753.hot-update.js", "JavaScript", 7, 0, 0, 0, 0, 11, 4, 22
"c:\Users\rfrjo\pothole-detection-website\.next\static\webpack\app\upload\page.836403eb24b7ffbd.hot-update.js", "JavaScript", -7, 0, 0, 0, 0, -11, -4, -22
"c:\Users\rfrjo\pothole-detection-website\.next\static\webpack\app\upload\page.87eae4974001cebd.hot-update.js", "JavaScript", -7, 0, 0, 0, 0, -11, -4, -22
"c:\Users\rfrjo\pothole-detection-website\.next\static\webpack\app\upload\page.8894e59acb5af99a.hot-update.js", "JavaScript", -7, 0, 0, 0, 0, -11, -4, -22
"c:\Users\rfrjo\pothole-detection-website\.next\static\webpack\app\upload\page.8cfc7e3849acd858.hot-update.js", "JavaScript", -7, 0, 0, 0, 0, -11, -4, -22
"c:\Users\rfrjo\pothole-detection-website\.next\static\webpack\app\upload\page.8d1022a00db06c96.hot-update.js", "JavaScript", 7, 0, 0, 0, 0, 11, 4, 22
"c:\Users\rfrjo\pothole-detection-website\.next\static\webpack\app\upload\page.8fd824ed7d27ab5d.hot-update.js", "JavaScript", -61, 0, 0, 0, 0, -56, -22, -139
"c:\Users\rfrjo\pothole-detection-website\.next\static\webpack\app\upload\page.90045a25807a574e.hot-update.js", "JavaScript", -7, 0, 0, 0, 0, -11, -4, -22
"c:\Users\rfrjo\pothole-detection-website\.next\static\webpack\app\upload\page.930cbca6693a54f4.hot-update.js", "JavaScript", -7, 0, 0, 0, 0, -11, -4, -22
"c:\Users\rfrjo\pothole-detection-website\.next\static\webpack\app\upload\page.94327a28070e9b59.hot-update.js", "JavaScript", 7, 0, 0, 0, 0, 11, 4, 22
"c:\Users\rfrjo\pothole-detection-website\.next\static\webpack\app\upload\page.949edd130e0d8b15.hot-update.js", "JavaScript", 7, 0, 0, 0, 0, 11, 4, 22
"c:\Users\rfrjo\pothole-detection-website\.next\static\webpack\app\upload\page.96ee604f28de5976.hot-update.js", "JavaScript", 7, 0, 0, 0, 0, 11, 4, 22
"c:\Users\rfrjo\pothole-detection-website\.next\static\webpack\app\upload\page.972e47f8fdb1b92a.hot-update.js", "JavaScript", -7, 0, 0, 0, 0, -11, -4, -22
"c:\Users\rfrjo\pothole-detection-website\.next\static\webpack\app\upload\page.988bbacd3bd4b4ed.hot-update.js", "JavaScript", -7, 0, 0, 0, 0, -11, -4, -22
"c:\Users\rfrjo\pothole-detection-website\.next\static\webpack\app\upload\page.99759e6ba0f88485.hot-update.js", "JavaScript", -7, 0, 0, 0, 0, -11, -4, -22
"c:\Users\rfrjo\pothole-detection-website\.next\static\webpack\app\upload\page.9a469bb35965f49b.hot-update.js", "JavaScript", 7, 0, 0, 0, 0, 11, 4, 22
"c:\Users\rfrjo\pothole-detection-website\.next\static\webpack\app\upload\page.9ab20fa73369eec1.hot-update.js", "JavaScript", -7, 0, 0, 0, 0, -11, -4, -22
"c:\Users\rfrjo\pothole-detection-website\.next\static\webpack\app\upload\page.9ab9d809f1c15a7c.hot-update.js", "JavaScript", -7, 0, 0, 0, 0, -11, -4, -22
"c:\Users\rfrjo\pothole-detection-website\.next\static\webpack\app\upload\page.9b177a6343dedfa5.hot-update.js", "JavaScript", 7, 0, 0, 0, 0, 11, 4, 22
"c:\Users\rfrjo\pothole-detection-website\.next\static\webpack\app\upload\page.9da82ad33978809b.hot-update.js", "JavaScript", -7, 0, 0, 0, 0, -11, -4, -22
"c:\Users\rfrjo\pothole-detection-website\.next\static\webpack\app\upload\page.a2a68842df227705.hot-update.js", "JavaScript", -7, 0, 0, 0, 0, -11, -4, -22
"c:\Users\rfrjo\pothole-detection-website\.next\static\webpack\app\upload\page.a63f32a84bd50758.hot-update.js", "JavaScript", -7, 0, 0, 0, 0, -11, -4, -22
"c:\Users\rfrjo\pothole-detection-website\.next\static\webpack\app\upload\page.a6f20656ebead5cb.hot-update.js", "JavaScript", -7, 0, 0, 0, 0, -11, -4, -22
"c:\Users\rfrjo\pothole-detection-website\.next\static\webpack\app\upload\page.a83439c9a62dd260.hot-update.js", "JavaScript", -11, 0, 0, 0, 0, -14, -7, -32
"c:\Users\rfrjo\pothole-detection-website\.next\static\webpack\app\upload\page.a88718d08d250638.hot-update.js", "JavaScript", 7, 0, 0, 0, 0, 11, 4, 22
"c:\Users\rfrjo\pothole-detection-website\.next\static\webpack\app\upload\page.a9862d632b38a6ac.hot-update.js", "JavaScript", -19, 0, 0, 0, 0, -20, -13, -52
"c:\Users\rfrjo\pothole-detection-website\.next\static\webpack\app\upload\page.ac63d61331c9c256.hot-update.js", "JavaScript", -7, 0, 0, 0, 0, -11, -4, -22
"c:\Users\rfrjo\pothole-detection-website\.next\static\webpack\app\upload\page.b00e9254685beba5.hot-update.js", "JavaScript", -7, 0, 0, 0, 0, -11, -4, -22
"c:\Users\rfrjo\pothole-detection-website\.next\static\webpack\app\upload\page.b356f9349f46c05f.hot-update.js", "JavaScript", -11, 0, 0, 0, 0, -14, -7, -32
"c:\Users\rfrjo\pothole-detection-website\.next\static\webpack\app\upload\page.b4935ee67ccb232c.hot-update.js", "JavaScript", 7, 0, 0, 0, 0, 11, 4, 22
"c:\Users\rfrjo\pothole-detection-website\.next\static\webpack\app\upload\page.be3da15174200697.hot-update.js", "JavaScript", 7, 0, 0, 0, 0, 11, 4, 22
"c:\Users\rfrjo\pothole-detection-website\.next\static\webpack\app\upload\page.be3e42fe055d75c9.hot-update.js", "JavaScript", 7, 0, 0, 0, 0, 11, 4, 22
"c:\Users\rfrjo\pothole-detection-website\.next\static\webpack\app\upload\page.c4ba3707ef3455b0.hot-update.js", "JavaScript", 7, 0, 0, 0, 0, 11, 4, 22
"c:\Users\rfrjo\pothole-detection-website\.next\static\webpack\app\upload\page.ca06906c618b58c0.hot-update.js", "JavaScript", -7, 0, 0, 0, 0, -11, -4, -22
"c:\Users\rfrjo\pothole-detection-website\.next\static\webpack\app\upload\page.cc804bd8b794cc35.hot-update.js", "JavaScript", -7, 0, 0, 0, 0, -11, -4, -22
"c:\Users\rfrjo\pothole-detection-website\.next\static\webpack\app\upload\page.cc9db873835968af.hot-update.js", "JavaScript", -7, 0, 0, 0, 0, -11, -4, -22
"c:\Users\rfrjo\pothole-detection-website\.next\static\webpack\app\upload\page.cd3728e5463e40ac.hot-update.js", "JavaScript", 5, 0, 0, 0, 0, 11, 5, 21
"c:\Users\rfrjo\pothole-detection-website\.next\static\webpack\app\upload\page.cd8b500c9d524f82.hot-update.js", "JavaScript", -7, 0, 0, 0, 0, -11, -4, -22
"c:\Users\rfrjo\pothole-detection-website\.next\static\webpack\app\upload\page.cddbb80b4fa7f701.hot-update.js", "JavaScript", -7, 0, 0, 0, 0, -11, -4, -22
"c:\Users\rfrjo\pothole-detection-website\.next\static\webpack\app\upload\page.d0e21abc3f17e927.hot-update.js", "JavaScript", -7, 0, 0, 0, 0, -11, -4, -22
"c:\Users\rfrjo\pothole-detection-website\.next\static\webpack\app\upload\page.d35bcc164f83e081.hot-update.js", "JavaScript", -7, 0, 0, 0, 0, -11, -4, -22
"c:\Users\rfrjo\pothole-detection-website\.next\static\webpack\app\upload\page.d3f9d5d6accb4bbb.hot-update.js", "JavaScript", 41, 0, 0, 0, 0, 32, 25, 98
"c:\Users\rfrjo\pothole-detection-website\.next\static\webpack\app\upload\page.d4cfa901868645e2.hot-update.js", "JavaScript", 15, 0, 0, 0, 0, 17, 10, 42
"c:\Users\rfrjo\pothole-detection-website\.next\static\webpack\app\upload\page.dc9aabb6db3bc5e2.hot-update.js", "JavaScript", -11, 0, 0, 0, 0, -14, -7, -32
"c:\Users\rfrjo\pothole-detection-website\.next\static\webpack\app\upload\page.dd156bdb1fdaed17.hot-update.js", "JavaScript", -7, 0, 0, 0, 0, -11, -4, -22
"c:\Users\rfrjo\pothole-detection-website\.next\static\webpack\app\upload\page.df6583e3b6affbbb.hot-update.js", "JavaScript", 7, 0, 0, 0, 0, 11, 4, 22
"c:\Users\rfrjo\pothole-detection-website\.next\static\webpack\app\upload\page.e8591e517137c060.hot-update.js", "JavaScript", -7, 0, 0, 0, 0, -11, -4, -22
"c:\Users\rfrjo\pothole-detection-website\.next\static\webpack\app\upload\page.e8b3f5af01348270.hot-update.js", "JavaScript", 7, 0, 0, 0, 0, 11, 4, 22
"c:\Users\rfrjo\pothole-detection-website\.next\static\webpack\app\upload\page.e90067ef8ce6181d.hot-update.js", "JavaScript", -7, 0, 0, 0, 0, -11, -4, -22
"c:\Users\rfrjo\pothole-detection-website\.next\static\webpack\app\upload\page.eb31eec642aac43d.hot-update.js", "JavaScript", -23, 0, 0, 0, 0, -23, -16, -62
"c:\Users\rfrjo\pothole-detection-website\.next\static\webpack\app\upload\page.eea850992acc70bf.hot-update.js", "JavaScript", -11, 0, 0, 0, 0, -14, -7, -32
"c:\Users\rfrjo\pothole-detection-website\.next\static\webpack\app\upload\page.ef06e8bcc4d5cc20.hot-update.js", "JavaScript", -7, 0, 0, 0, 0, -11, -4, -22
"c:\Users\rfrjo\pothole-detection-website\.next\static\webpack\app\upload\page.f00f7e380c8004ef.hot-update.js", "JavaScript", 7, 0, 0, 0, 0, 11, 4, 22
"c:\Users\rfrjo\pothole-detection-website\.next\static\webpack\app\upload\page.f08265c37c969fb9.hot-update.js", "JavaScript", -7, 0, 0, 0, 0, -11, -4, -22
"c:\Users\rfrjo\pothole-detection-website\.next\static\webpack\app\upload\page.f51ef73fe7ab9246.hot-update.js", "JavaScript", 7, 0, 0, 0, 0, 11, 4, 22
"c:\Users\rfrjo\pothole-detection-website\.next\static\webpack\app\upload\page.f88d041dae8d9828.hot-update.js", "JavaScript", 7, 0, 0, 0, 0, 11, 4, 22
"c:\Users\rfrjo\pothole-detection-website\.next\static\webpack\app\upload\page.f9de1ca68fbbf2ec.hot-update.js", "JavaScript", 453, 0, 0, 0, 0, 281, 274, 1008
"c:\Users\rfrjo\pothole-detection-website\.next\static\webpack\app\upload\page.fb7ae82af7c3ab0d.hot-update.js", "JavaScript", 7, 0, 0, 0, 0, 11, 4, 22
"c:\Users\rfrjo\pothole-detection-website\.next\static\webpack\app\upload\page.fbe4fd7e0754fbdb.hot-update.js", "JavaScript", -7, 0, 0, 0, 0, -11, -4, -22
"c:\Users\rfrjo\pothole-detection-website\.next\static\webpack\app\upload\page.fc51d71f73067d3f.hot-update.js", "JavaScript", -7, 0, 0, 0, 0, -11, -4, -22
"c:\Users\rfrjo\pothole-detection-website\.next\static\webpack\app\upload\page.fe049f32ee0f38ef.hot-update.js", "JavaScript", 7, 0, 0, 0, 0, 11, 4, 22
"c:\Users\rfrjo\pothole-detection-website\.next\static\webpack\b00e9254685beba5.webpack.hot-update.json", "JSON", 0, 0, -1, 0, 0, 0, 0, -1
"c:\Users\rfrjo\pothole-detection-website\.next\static\webpack\b202d06b191d5f76.webpack.hot-update.json", "JSON", 0, 0, -1, 0, 0, 0, 0, -1
"c:\Users\rfrjo\pothole-detection-website\.next\static\webpack\b33251ce981b4e64.webpack.hot-update.json", "JSON", 0, 0, -1, 0, 0, 0, 0, -1
"c:\Users\rfrjo\pothole-detection-website\.next\static\webpack\b356f9349f46c05f.webpack.hot-update.json", "JSON", 0, 0, -1, 0, 0, 0, 0, -1
"c:\Users\rfrjo\pothole-detection-website\.next\static\webpack\b4935ee67ccb232c.webpack.hot-update.json", "JSON", 0, 0, 1, 0, 0, 0, 0, 1
"c:\Users\rfrjo\pothole-detection-website\.next\static\webpack\b58f405b4f945bc5.webpack.hot-update.json", "JSON", 0, 0, -1, 0, 0, 0, 0, -1
"c:\Users\rfrjo\pothole-detection-website\.next\static\webpack\b6fccb5d616f7190.webpack.hot-update.json", "JSON", 0, 0, -1, 0, 0, 0, 0, -1
"c:\Users\rfrjo\pothole-detection-website\.next\static\webpack\b724e9efc9d6f974.webpack.hot-update.json", "JSON", 0, 0, -1, 0, 0, 0, 0, -1
"c:\Users\rfrjo\pothole-detection-website\.next\static\webpack\b9b6070c1ac65dfc.webpack.hot-update.json", "JSON", 0, 0, -1, 0, 0, 0, 0, -1
"c:\Users\rfrjo\pothole-detection-website\.next\static\webpack\ba3c414df75c4b96.webpack.hot-update.json", "JSON", 0, 0, -1, 0, 0, 0, 0, -1
"c:\Users\rfrjo\pothole-detection-website\.next\static\webpack\bd975f57d9c1d99b.webpack.hot-update.json", "JSON", 0, 0, -1, 0, 0, 0, 0, -1
"c:\Users\rfrjo\pothole-detection-website\.next\static\webpack\be3da15174200697.webpack.hot-update.json", "JSON", 0, 0, 1, 0, 0, 0, 0, 1
"c:\Users\rfrjo\pothole-detection-website\.next\static\webpack\be3e42fe055d75c9.webpack.hot-update.json", "JSON", 0, 0, 1, 0, 0, 0, 0, 1
"c:\Users\rfrjo\pothole-detection-website\.next\static\webpack\c174dae197df82fa.webpack.hot-update.json", "JSON", 0, 0, 1, 0, 0, 0, 0, 1
"c:\Users\rfrjo\pothole-detection-website\.next\static\webpack\c198d3adce0d1177.webpack.hot-update.json", "JSON", 0, 0, -1, 0, 0, 0, 0, -1
"c:\Users\rfrjo\pothole-detection-website\.next\static\webpack\c2f90dd08b817d3a.webpack.hot-update.json", "JSON", 0, 0, -1, 0, 0, 0, 0, -1
"c:\Users\rfrjo\pothole-detection-website\.next\static\webpack\c4ba3707ef3455b0.webpack.hot-update.json", "JSON", 0, 0, 1, 0, 0, 0, 0, 1
"c:\Users\rfrjo\pothole-detection-website\.next\static\webpack\c51eb2b4dce68746.webpack.hot-update.json", "JSON", 0, 0, -1, 0, 0, 0, 0, -1
"c:\Users\rfrjo\pothole-detection-website\.next\static\webpack\c79ca73a382824b7.webpack.hot-update.json", "JSON", 0, 0, -1, 0, 0, 0, 0, -1
"c:\Users\rfrjo\pothole-detection-website\.next\static\webpack\c7ebeba584f48140.webpack.hot-update.json", "JSON", 0, 0, -1, 0, 0, 0, 0, -1
"c:\Users\rfrjo\pothole-detection-website\.next\static\webpack\c863c433a47baf3d.webpack.hot-update.json", "JSON", 0, 0, 1, 0, 0, 0, 0, 1
"c:\Users\rfrjo\pothole-detection-website\.next\static\webpack\ca06906c618b58c0.webpack.hot-update.json", "JSON", 0, 0, -1, 0, 0, 0, 0, -1
"c:\Users\rfrjo\pothole-detection-website\.next\static\webpack\ca98b2f35be87c40.webpack.hot-update.json", "JSON", 0, 0, -1, 0, 0, 0, 0, -1
"c:\Users\rfrjo\pothole-detection-website\.next\static\webpack\cc78697ad538e48d.webpack.hot-update.json", "JSON", 0, 0, -1, 0, 0, 0, 0, -1
"c:\Users\rfrjo\pothole-detection-website\.next\static\webpack\cc804bd8b794cc35.webpack.hot-update.json", "JSON", 0, 0, -1, 0, 0, 0, 0, -1
"c:\Users\rfrjo\pothole-detection-website\.next\static\webpack\cc9db873835968af.webpack.hot-update.json", "JSON", 0, 0, -1, 0, 0, 0, 0, -1
"c:\Users\rfrjo\pothole-detection-website\.next\static\webpack\cd33e8b75fd3d567.webpack.hot-update.json", "JSON", 0, 0, 1, 0, 0, 0, 0, 1
"c:\Users\rfrjo\pothole-detection-website\.next\static\webpack\cd3728e5463e40ac.webpack.hot-update.json", "JSON", 0, 0, 1, 0, 0, 0, 0, 1
"c:\Users\rfrjo\pothole-detection-website\.next\static\webpack\cd89fb3069b50aab.webpack.hot-update.json", "JSON", 0, 0, -1, 0, 0, 0, 0, -1
"c:\Users\rfrjo\pothole-detection-website\.next\static\webpack\cd8b500c9d524f82.webpack.hot-update.json", "JSON", 0, 0, -1, 0, 0, 0, 0, -1
"c:\Users\rfrjo\pothole-detection-website\.next\static\webpack\cddbb80b4fa7f701.webpack.hot-update.json", "JSON", 0, 0, -1, 0, 0, 0, 0, -1
"c:\Users\rfrjo\pothole-detection-website\.next\static\webpack\cf1be1f66aaef90c.webpack.hot-update.json", "JSON", 0, 0, 1, 0, 0, 0, 0, 1
"c:\Users\rfrjo\pothole-detection-website\.next\static\webpack\cf5421d78a074520.webpack.hot-update.json", "JSON", 0, 0, -1, 0, 0, 0, 0, -1
"c:\Users\rfrjo\pothole-detection-website\.next\static\webpack\cfb96863d6bdef00.webpack.hot-update.json", "JSON", 0, 0, 1, 0, 0, 0, 0, 1
"c:\Users\rfrjo\pothole-detection-website\.next\static\webpack\d0e21abc3f17e927.webpack.hot-update.json", "JSON", 0, 0, -1, 0, 0, 0, 0, -1
"c:\Users\rfrjo\pothole-detection-website\.next\static\webpack\d26a62214cbd792d.webpack.hot-update.json", "JSON", 0, 0, -1, 0, 0, 0, 0, -1
"c:\Users\rfrjo\pothole-detection-website\.next\static\webpack\d2b39e3fbc806218.webpack.hot-update.json", "JSON", 0, 0, 1, 0, 0, 0, 0, 1
"c:\Users\rfrjo\pothole-detection-website\.next\static\webpack\d35bcc164f83e081.webpack.hot-update.json", "JSON", 0, 0, -1, 0, 0, 0, 0, -1
"c:\Users\rfrjo\pothole-detection-website\.next\static\webpack\d3f9d5d6accb4bbb.webpack.hot-update.json", "JSON", 0, 0, 1, 0, 0, 0, 0, 1
"c:\Users\rfrjo\pothole-detection-website\.next\static\webpack\d46b0477114cd521.webpack.hot-update.json", "JSON", 0, 0, -1, 0, 0, 0, 0, -1
"c:\Users\rfrjo\pothole-detection-website\.next\static\webpack\d4cfa901868645e2.webpack.hot-update.json", "JSON", 0, 0, 1, 0, 0, 0, 0, 1
"c:\Users\rfrjo\pothole-detection-website\.next\static\webpack\d7f4b3c0f1019bfb.webpack.hot-update.json", "JSON", 0, 0, -1, 0, 0, 0, 0, -1
"c:\Users\rfrjo\pothole-detection-website\.next\static\webpack\d811744dbedd33fe.webpack.hot-update.json", "JSON", 0, 0, -1, 0, 0, 0, 0, -1
"c:\Users\rfrjo\pothole-detection-website\.next\static\webpack\d8b408ff1213441e.webpack.hot-update.json", "JSON", 0, 0, 1, 0, 0, 0, 0, 1
"c:\Users\rfrjo\pothole-detection-website\.next\static\webpack\d9a2c09833ac5b84.webpack.hot-update.json", "JSON", 0, 0, -1, 0, 0, 0, 0, -1
"c:\Users\rfrjo\pothole-detection-website\.next\static\webpack\d9d9e8eb36e4a319.webpack.hot-update.json", "JSON", 0, 0, -1, 0, 0, 0, 0, -1
"c:\Users\rfrjo\pothole-detection-website\.next\static\webpack\da189dca28b2fd71.webpack.hot-update.json", "JSON", 0, 0, -1, 0, 0, 0, 0, -1
"c:\Users\rfrjo\pothole-detection-website\.next\static\webpack\da6ee9ed3accfd7c.webpack.hot-update.json", "JSON", 0, 0, -1, 0, 0, 0, 0, -1
"c:\Users\rfrjo\pothole-detection-website\.next\static\webpack\dc9aabb6db3bc5e2.webpack.hot-update.json", "JSON", 0, 0, -1, 0, 0, 0, 0, -1
"c:\Users\rfrjo\pothole-detection-website\.next\static\webpack\dd156bdb1fdaed17.webpack.hot-update.json", "JSON", 0, 0, -1, 0, 0, 0, 0, -1
"c:\Users\rfrjo\pothole-detection-website\.next\static\webpack\df6583e3b6affbbb.webpack.hot-update.json", "JSON", 0, 0, 1, 0, 0, 0, 0, 1
"c:\Users\rfrjo\pothole-detection-website\.next\static\webpack\e0aa062d3cdf4a32.webpack.hot-update.json", "JSON", 0, 0, -1, 0, 0, 0, 0, -1
"c:\Users\rfrjo\pothole-detection-website\.next\static\webpack\e0e9443637d32cb1.webpack.hot-update.json", "JSON", 0, 0, -1, 0, 0, 0, 0, -1
"c:\Users\rfrjo\pothole-detection-website\.next\static\webpack\e10874c4bc226ea0.webpack.hot-update.json", "JSON", 0, 0, -1, 0, 0, 0, 0, -1
"c:\Users\rfrjo\pothole-detection-website\.next\static\webpack\e3ff949e143f65d2.webpack.hot-update.json", "JSON", 0, 0, -1, 0, 0, 0, 0, -1
"c:\Users\rfrjo\pothole-detection-website\.next\static\webpack\e8591e517137c060.webpack.hot-update.json", "JSON", 0, 0, -1, 0, 0, 0, 0, -1
"c:\Users\rfrjo\pothole-detection-website\.next\static\webpack\e8b3f5af01348270.webpack.hot-update.json", "JSON", 0, 0, 1, 0, 0, 0, 0, 1
"c:\Users\rfrjo\pothole-detection-website\.next\static\webpack\e90067ef8ce6181d.webpack.hot-update.json", "JSON", 0, 0, -1, 0, 0, 0, 0, -1
"c:\Users\rfrjo\pothole-detection-website\.next\static\webpack\e94531ca0dfc0721.webpack.hot-update.json", "JSON", 0, 0, -1, 0, 0, 0, 0, -1
"c:\Users\rfrjo\pothole-detection-website\.next\static\webpack\eafe582f0f415f2e.webpack.hot-update.json", "JSON", 0, 0, -1, 0, 0, 0, 0, -1
"c:\Users\rfrjo\pothole-detection-website\.next\static\webpack\eb31eec642aac43d.webpack.hot-update.json", "JSON", 0, 0, -1, 0, 0, 0, 0, -1
"c:\Users\rfrjo\pothole-detection-website\.next\static\webpack\eb6c58442bbef117.webpack.hot-update.json", "JSON", 0, 0, -1, 0, 0, 0, 0, -1
"c:\Users\rfrjo\pothole-detection-website\.next\static\webpack\ee0348281aac2ba8.webpack.hot-update.json", "JSON", 0, 0, -1, 0, 0, 0, 0, -1
"c:\Users\rfrjo\pothole-detection-website\.next\static\webpack\eea850992acc70bf.webpack.hot-update.json", "JSON", 0, 0, -1, 0, 0, 0, 0, -1
"c:\Users\rfrjo\pothole-detection-website\.next\static\webpack\eec024fae8f4e249.webpack.hot-update.json", "JSON", 0, 0, -1, 0, 0, 0, 0, -1
"c:\Users\rfrjo\pothole-detection-website\.next\static\webpack\ef06e8bcc4d5cc20.webpack.hot-update.json", "JSON", 0, 0, -1, 0, 0, 0, 0, -1
"c:\Users\rfrjo\pothole-detection-website\.next\static\webpack\f00f7e380c8004ef.webpack.hot-update.json", "JSON", 0, 0, 1, 0, 0, 0, 0, 1
"c:\Users\rfrjo\pothole-detection-website\.next\static\webpack\f08265c37c969fb9.webpack.hot-update.json", "JSON", 0, 0, -1, 0, 0, 0, 0, -1
"c:\Users\rfrjo\pothole-detection-website\.next\static\webpack\f2792f19a4cb8f1e.webpack.hot-update.json", "JSON", 0, 0, -1, 0, 0, 0, 0, -1
"c:\Users\rfrjo\pothole-detection-website\.next\static\webpack\f2a913967631bb19.webpack.hot-update.json", "JSON", 0, 0, -1, 0, 0, 0, 0, -1
"c:\Users\rfrjo\pothole-detection-website\.next\static\webpack\f3323091d852bbdc.webpack.hot-update.json", "JSON", 0, 0, -1, 0, 0, 0, 0, -1
"c:\Users\rfrjo\pothole-detection-website\.next\static\webpack\f33d64cb0afa3b86.webpack.hot-update.json", "JSON", 0, 0, -1, 0, 0, 0, 0, -1
"c:\Users\rfrjo\pothole-detection-website\.next\static\webpack\f3561c083243df06.webpack.hot-update.json", "JSON", 0, 0, -1, 0, 0, 0, 0, -1
"c:\Users\rfrjo\pothole-detection-website\.next\static\webpack\f47b825168d22aa0.webpack.hot-update.json", "JSON", 0, 0, -1, 0, 0, 0, 0, -1
"c:\Users\rfrjo\pothole-detection-website\.next\static\webpack\f47de2872720f503.webpack.hot-update.json", "JSON", 0, 0, -1, 0, 0, 0, 0, -1
"c:\Users\rfrjo\pothole-detection-website\.next\static\webpack\f51ef73fe7ab9246.webpack.hot-update.json", "JSON", 0, 0, 1, 0, 0, 0, 0, 1
"c:\Users\rfrjo\pothole-detection-website\.next\static\webpack\f71e8e55740cd286.webpack.hot-update.json", "JSON", 0, 0, 1, 0, 0, 0, 0, 1
"c:\Users\rfrjo\pothole-detection-website\.next\static\webpack\f88d041dae8d9828.webpack.hot-update.json", "JSON", 0, 0, 1, 0, 0, 0, 0, 1
"c:\Users\rfrjo\pothole-detection-website\.next\static\webpack\f9520265e142ad5e.webpack.hot-update.json", "JSON", 0, 0, -1, 0, 0, 0, 0, -1
"c:\Users\rfrjo\pothole-detection-website\.next\static\webpack\f9c5fb343c296e1c.webpack.hot-update.json", "JSON", 0, 0, 1, 0, 0, 0, 0, 1
"c:\Users\rfrjo\pothole-detection-website\.next\static\webpack\f9de1ca68fbbf2ec.webpack.hot-update.json", "JSON", 0, 0, 1, 0, 0, 0, 0, 1
"c:\Users\rfrjo\pothole-detection-website\.next\static\webpack\fa7fd5fadcff3ac4.webpack.hot-update.json", "JSON", 0, 0, -1, 0, 0, 0, 0, -1
"c:\Users\rfrjo\pothole-detection-website\.next\static\webpack\fb7ae82af7c3ab0d.webpack.hot-update.json", "JSON", 0, 0, 1, 0, 0, 0, 0, 1
"c:\Users\rfrjo\pothole-detection-website\.next\static\webpack\fbe4fd7e0754fbdb.webpack.hot-update.json", "JSON", 0, 0, -1, 0, 0, 0, 0, -1
"c:\Users\rfrjo\pothole-detection-website\.next\static\webpack\fbe925cde8eeb7dc.webpack.hot-update.json", "JSON", 0, 0, -1, 0, 0, 0, 0, -1
"c:\Users\rfrjo\pothole-detection-website\.next\static\webpack\fc51d71f73067d3f.webpack.hot-update.json", "JSON", 0, 0, -1, 0, 0, 0, 0, -1
"c:\Users\rfrjo\pothole-detection-website\.next\static\webpack\fe049f32ee0f38ef.webpack.hot-update.json", "JSON", 0, 0, 1, 0, 0, 0, 0, 1
"c:\Users\rfrjo\pothole-detection-website\.next\static\webpack\fe18180edebcb09e.webpack.hot-update.json", "JSON", 0, 0, -1, 0, 0, 0, 0, -1
"c:\Users\rfrjo\pothole-detection-website\.next\static\webpack\ffb54dfc8e5706f9.webpack.hot-update.json", "JSON", 0, 0, -1, 0, 0, 0, 0, -1
"c:\Users\rfrjo\pothole-detection-website\.next\static\webpack\main.e94531ca0dfc0721.hot-update.js", "JavaScript", -7, 0, 0, 0, 0, -11, -4, -22
"c:\Users\rfrjo\pothole-detection-website\.next\static\webpack\webpack.03f416adaa618df1.hot-update.js", "JavaScript", 9, 0, 0, 0, 0, 9, 0, 18
"c:\Users\rfrjo\pothole-detection-website\.next\static\webpack\webpack.052f6dea2efbf9c3.hot-update.js", "JavaScript", 9, 0, 0, 0, 0, 9, 0, 18
"c:\Users\rfrjo\pothole-detection-website\.next\static\webpack\webpack.05715a168cba21da.hot-update.js", "JavaScript", 9, 0, 0, 0, 0, 9, 0, 18
"c:\Users\rfrjo\pothole-detection-website\.next\static\webpack\webpack.08e6a1720712c1de.hot-update.js", "JavaScript", -9, 0, 0, 0, 0, -9, 0, -18
"c:\Users\rfrjo\pothole-detection-website\.next\static\webpack\webpack.09f2854a07611b91.hot-update.js", "JavaScript", 9, 0, 0, 0, 0, 9, 0, 18
"c:\Users\rfrjo\pothole-detection-website\.next\static\webpack\webpack.0e556f7ecf57b136.hot-update.js", "JavaScript", -9, 0, 0, 0, 0, -9, 0, -18
"c:\Users\rfrjo\pothole-detection-website\.next\static\webpack\webpack.0ef0af934fc2b140.hot-update.js", "JavaScript", -9, 0, 0, 0, 0, -9, 0, -18
"c:\Users\rfrjo\pothole-detection-website\.next\static\webpack\webpack.0f59587d0a6f5dd0.hot-update.js", "JavaScript", 9, 0, 0, 0, 0, 9, 0, 18
"c:\Users\rfrjo\pothole-detection-website\.next\static\webpack\webpack.1019e17dc34f90f7.hot-update.js", "JavaScript", -9, 0, 0, 0, 0, -9, 0, -18
"c:\Users\rfrjo\pothole-detection-website\.next\static\webpack\webpack.10d06a07761b1004.hot-update.js", "JavaScript", -9, 0, 0, 0, 0, -9, 0, -18
"c:\Users\rfrjo\pothole-detection-website\.next\static\webpack\webpack.10f36f7c29af944b.hot-update.js", "JavaScript", -9, 0, 0, 0, 0, -9, 0, -18
"c:\Users\rfrjo\pothole-detection-website\.next\static\webpack\webpack.11f5b055fd4bd836.hot-update.js", "JavaScript", -9, 0, 0, 0, 0, -9, 0, -18
"c:\Users\rfrjo\pothole-detection-website\.next\static\webpack\webpack.139d8656c3bb11a5.hot-update.js", "JavaScript", -9, 0, 0, 0, 0, -9, 0, -18
"c:\Users\rfrjo\pothole-detection-website\.next\static\webpack\webpack.14f23adcc8b61558.hot-update.js", "JavaScript", -13, 0, 0, 0, 0, -10, 0, -23
"c:\Users\rfrjo\pothole-detection-website\.next\static\webpack\webpack.15118643dcb53d1a.hot-update.js", "JavaScript", -9, 0, 0, 0, 0, -9, 0, -18
"c:\Users\rfrjo\pothole-detection-website\.next\static\webpack\webpack.15533c9ad4427e70.hot-update.js", "JavaScript", -9, 0, 0, 0, 0, -9, 0, -18
"c:\Users\rfrjo\pothole-detection-website\.next\static\webpack\webpack.16a32586d354b631.hot-update.js", "JavaScript", 9, 0, 0, 0, 0, 9, 0, 18
"c:\Users\rfrjo\pothole-detection-website\.next\static\webpack\webpack.1b6b2212351d04eb.hot-update.js", "JavaScript", 9, 0, 0, 0, 0, 9, 0, 18
"c:\Users\rfrjo\pothole-detection-website\.next\static\webpack\webpack.1bf57e9ca108224a.hot-update.js", "JavaScript", 9, 0, 0, 0, 0, 9, 0, 18
"c:\Users\rfrjo\pothole-detection-website\.next\static\webpack\webpack.1c27704668b698fe.hot-update.js", "JavaScript", -9, 0, 0, 0, 0, -9, 0, -18
"c:\Users\rfrjo\pothole-detection-website\.next\static\webpack\webpack.1c32acae818838c2.hot-update.js", "JavaScript", -9, 0, 0, 0, 0, -9, 0, -18
"c:\Users\rfrjo\pothole-detection-website\.next\static\webpack\webpack.1d34ad3f0c956b35.hot-update.js", "JavaScript", 9, 0, 0, 0, 0, 9, 0, 18
"c:\Users\rfrjo\pothole-detection-website\.next\static\webpack\webpack.1d5788842318190b.hot-update.js", "JavaScript", 9, 0, 0, 0, 0, 9, 0, 18
"c:\Users\rfrjo\pothole-detection-website\.next\static\webpack\webpack.1e178d13d373339b.hot-update.js", "JavaScript", -9, 0, 0, 0, 0, -9, 0, -18
"c:\Users\rfrjo\pothole-detection-website\.next\static\webpack\webpack.1e3b0b7a7dabaae1.hot-update.js", "JavaScript", -9, 0, 0, 0, 0, -9, 0, -18
"c:\Users\rfrjo\pothole-detection-website\.next\static\webpack\webpack.1eaa88a0999b1364.hot-update.js", "JavaScript", -9, 0, 0, 0, 0, -9, 0, -18
"c:\Users\rfrjo\pothole-detection-website\.next\static\webpack\webpack.1f834d24ad74b4f6.hot-update.js", "JavaScript", 9, 0, 0, 0, 0, 9, 0, 18
"c:\Users\rfrjo\pothole-detection-website\.next\static\webpack\webpack.1f9d5f14b6b613da.hot-update.js", "JavaScript", -9, 0, 0, 0, 0, -9, 0, -18
"c:\Users\rfrjo\pothole-detection-website\.next\static\webpack\webpack.237a39fa8ef5c6e3.hot-update.js", "JavaScript", -9, 0, 0, 0, 0, -9, 0, -18
"c:\Users\rfrjo\pothole-detection-website\.next\static\webpack\webpack.23a5b02801af775d.hot-update.js", "JavaScript", -9, 0, 0, 0, 0, -9, 0, -18
"c:\Users\rfrjo\pothole-detection-website\.next\static\webpack\webpack.241e6549ff2bdfb9.hot-update.js", "JavaScript", 9, 0, 0, 0, 0, 9, 0, 18
"c:\Users\rfrjo\pothole-detection-website\.next\static\webpack\webpack.2437995ad6de6d44.hot-update.js", "JavaScript", 9, 0, 0, 0, 0, 9, 0, 18
"c:\Users\rfrjo\pothole-detection-website\.next\static\webpack\webpack.2447dcefc4d408c0.hot-update.js", "JavaScript", 9, 0, 0, 0, 0, 9, 0, 18
"c:\Users\rfrjo\pothole-detection-website\.next\static\webpack\webpack.2581eb8befa4fe57.hot-update.js", "JavaScript", -9, 0, 0, 0, 0, -9, 0, -18
"c:\Users\rfrjo\pothole-detection-website\.next\static\webpack\webpack.25e2634e463d29f1.hot-update.js", "JavaScript", -9, 0, 0, 0, 0, -9, 0, -18
"c:\Users\rfrjo\pothole-detection-website\.next\static\webpack\webpack.261582b8a4c03c81.hot-update.js", "JavaScript", 9, 0, 0, 0, 0, 9, 0, 18
"c:\Users\rfrjo\pothole-detection-website\.next\static\webpack\webpack.26b9be174d75f607.hot-update.js", "JavaScript", -9, 0, 0, 0, 0, -9, 0, -18
"c:\Users\rfrjo\pothole-detection-website\.next\static\webpack\webpack.27f6d42552c967a9.hot-update.js", "JavaScript", -9, 0, 0, 0, 0, -9, 0, -18
"c:\Users\rfrjo\pothole-detection-website\.next\static\webpack\webpack.2af20e4231425d85.hot-update.js", "JavaScript", 9, 0, 0, 0, 0, 9, 0, 18
"c:\Users\rfrjo\pothole-detection-website\.next\static\webpack\webpack.2bfff34f33985a5c.hot-update.js", "JavaScript", 9, 0, 0, 0, 0, 9, 0, 18
"c:\Users\rfrjo\pothole-detection-website\.next\static\webpack\webpack.2c8586f1d74b8d89.hot-update.js", "JavaScript", -9, 0, 0, 0, 0, -9, 0, -18
"c:\Users\rfrjo\pothole-detection-website\.next\static\webpack\webpack.2df75f17c78eeaf1.hot-update.js", "JavaScript", 9, 0, 0, 0, 0, 9, 0, 18
"c:\Users\rfrjo\pothole-detection-website\.next\static\webpack\webpack.2f8ca1b723b8efb7.hot-update.js", "JavaScript", -9, 0, 0, 0, 0, -9, 0, -18
"c:\Users\rfrjo\pothole-detection-website\.next\static\webpack\webpack.2f9f2a69e2e50e87.hot-update.js", "JavaScript", -9, 0, 0, 0, 0, -9, 0, -18
"c:\Users\rfrjo\pothole-detection-website\.next\static\webpack\webpack.3075e1cd05d6febe.hot-update.js", "JavaScript", -9, 0, 0, 0, 0, -9, 0, -18
"c:\Users\rfrjo\pothole-detection-website\.next\static\webpack\webpack.336c5b89b535e2de.hot-update.js", "JavaScript", 9, 0, 0, 0, 0, 9, 0, 18
"c:\Users\rfrjo\pothole-detection-website\.next\static\webpack\webpack.35543311e684b41b.hot-update.js", "JavaScript", -9, 0, 0, 0, 0, -9, 0, -18
"c:\Users\rfrjo\pothole-detection-website\.next\static\webpack\webpack.35bbf55acd2f0777.hot-update.js", "JavaScript", -9, 0, 0, 0, 0, -9, 0, -18
"c:\Users\rfrjo\pothole-detection-website\.next\static\webpack\webpack.36277ac7fedd49ae.hot-update.js", "JavaScript", -9, 0, 0, 0, 0, -9, 0, -18
"c:\Users\rfrjo\pothole-detection-website\.next\static\webpack\webpack.366f97835718ae55.hot-update.js", "JavaScript", -9, 0, 0, 0, 0, -9, 0, -18
"c:\Users\rfrjo\pothole-detection-website\.next\static\webpack\webpack.36ecf676eed32104.hot-update.js", "JavaScript", -9, 0, 0, 0, 0, -9, 0, -18
"c:\Users\rfrjo\pothole-detection-website\.next\static\webpack\webpack.3703bf15d620330d.hot-update.js", "JavaScript", -9, 0, 0, 0, 0, -9, 0, -18
"c:\Users\rfrjo\pothole-detection-website\.next\static\webpack\webpack.382141e07fdcde74.hot-update.js", "JavaScript", -9, 0, 0, 0, 0, -9, 0, -18
"c:\Users\rfrjo\pothole-detection-website\.next\static\webpack\webpack.38eee2056242a06d.hot-update.js", "JavaScript", -9, 0, 0, 0, 0, -9, 0, -18
"c:\Users\rfrjo\pothole-detection-website\.next\static\webpack\webpack.395562a4717d2f7f.hot-update.js", "JavaScript", 9, 0, 0, 0, 0, 9, 0, 18
"c:\Users\rfrjo\pothole-detection-website\.next\static\webpack\webpack.3af8302a34ff3f9b.hot-update.js", "JavaScript", 9, 0, 0, 0, 0, 9, 0, 18
"c:\Users\rfrjo\pothole-detection-website\.next\static\webpack\webpack.3c4b6483cb36fe68.hot-update.js", "JavaScript", -9, 0, 0, 0, 0, -9, 0, -18
"c:\Users\rfrjo\pothole-detection-website\.next\static\webpack\webpack.3ca36a23adbbd0d4.hot-update.js", "JavaScript", -9, 0, 0, 0, 0, -9, 0, -18
"c:\Users\rfrjo\pothole-detection-website\.next\static\webpack\webpack.3ceff98b83edd5ba.hot-update.js", "JavaScript", -9, 0, 0, 0, 0, -9, 0, -18
"c:\Users\rfrjo\pothole-detection-website\.next\static\webpack\webpack.3d3bada15a49a51a.hot-update.js", "JavaScript", 9, 0, 0, 0, 0, 9, 0, 18
"c:\Users\rfrjo\pothole-detection-website\.next\static\webpack\webpack.3f143ce00dddf463.hot-update.js", "JavaScript", -9, 0, 0, 0, 0, -9, 0, -18
"c:\Users\rfrjo\pothole-detection-website\.next\static\webpack\webpack.3fd574372d51d356.hot-update.js", "JavaScript", -9, 0, 0, 0, 0, -9, 0, -18
"c:\Users\rfrjo\pothole-detection-website\.next\static\webpack\webpack.40295ba76eb93afd.hot-update.js", "JavaScript", -9, 0, 0, 0, 0, -9, 0, -18
"c:\Users\rfrjo\pothole-detection-website\.next\static\webpack\webpack.404846168f14f227.hot-update.js", "JavaScript", -9, 0, 0, 0, 0, -9, 0, -18
"c:\Users\rfrjo\pothole-detection-website\.next\static\webpack\webpack.437e40c658bb17cd.hot-update.js", "JavaScript", -9, 0, 0, 0, 0, -9, 0, -18
"c:\Users\rfrjo\pothole-detection-website\.next\static\webpack\webpack.44288f0073fcc4b9.hot-update.js", "JavaScript", -9, 0, 0, 0, 0, -9, 0, -18
"c:\Users\rfrjo\pothole-detection-website\.next\static\webpack\webpack.47396008231a81e3.hot-update.js", "JavaScript", 9, 0, 0, 0, 0, 9, 0, 18
"c:\Users\rfrjo\pothole-detection-website\.next\static\webpack\webpack.478146370f32c537.hot-update.js", "JavaScript", -9, 0, 0, 0, 0, -9, 0, -18
"c:\Users\rfrjo\pothole-detection-website\.next\static\webpack\webpack.4936085bfb196153.hot-update.js", "JavaScript", -9, 0, 0, 0, 0, -9, 0, -18
"c:\Users\rfrjo\pothole-detection-website\.next\static\webpack\webpack.4973ea30c81c600a.hot-update.js", "JavaScript", -9, 0, 0, 0, 0, -9, 0, -18
"c:\Users\rfrjo\pothole-detection-website\.next\static\webpack\webpack.497efc25dbe6dd76.hot-update.js", "JavaScript", -9, 0, 0, 0, 0, -9, 0, -18
"c:\Users\rfrjo\pothole-detection-website\.next\static\webpack\webpack.499d0255c918291e.hot-update.js", "JavaScript", -9, 0, 0, 0, 0, -9, 0, -18
"c:\Users\rfrjo\pothole-detection-website\.next\static\webpack\webpack.4aadc740f0277373.hot-update.js", "JavaScript", -9, 0, 0, 0, 0, -9, 0, -18
"c:\Users\rfrjo\pothole-detection-website\.next\static\webpack\webpack.4acf9e39d300fd5c.hot-update.js", "JavaScript", -9, 0, 0, 0, 0, -9, 0, -18
"c:\Users\rfrjo\pothole-detection-website\.next\static\webpack\webpack.4b294efc754c21b7.hot-update.js", "JavaScript", -9, 0, 0, 0, 0, -9, 0, -18
"c:\Users\rfrjo\pothole-detection-website\.next\static\webpack\webpack.4bac7e0d3bc694aa.hot-update.js", "JavaScript", -9, 0, 0, 0, 0, -9, 0, -18
"c:\Users\rfrjo\pothole-detection-website\.next\static\webpack\webpack.4be6c3196b0e7880.hot-update.js", "JavaScript", 9, 0, 0, 0, 0, 9, 0, 18
"c:\Users\rfrjo\pothole-detection-website\.next\static\webpack\webpack.4cc9dfe53752ec11.hot-update.js", "JavaScript", 9, 0, 0, 0, 0, 9, 0, 18
"c:\Users\rfrjo\pothole-detection-website\.next\static\webpack\webpack.4df61bd6841d5eac.hot-update.js", "JavaScript", -9, 0, 0, 0, 0, -9, 0, -18
"c:\Users\rfrjo\pothole-detection-website\.next\static\webpack\webpack.4e4c07c1c572ae5f.hot-update.js", "JavaScript", 9, 0, 0, 0, 0, 9, 0, 18
"c:\Users\rfrjo\pothole-detection-website\.next\static\webpack\webpack.4e7177463858ed6a.hot-update.js", "JavaScript", 9, 0, 0, 0, 0, 9, 0, 18
"c:\Users\rfrjo\pothole-detection-website\.next\static\webpack\webpack.4ff81d283a481acd.hot-update.js", "JavaScript", -9, 0, 0, 0, 0, -9, 0, -18
"c:\Users\rfrjo\pothole-detection-website\.next\static\webpack\webpack.52a6ee1060dbb5bd.hot-update.js", "JavaScript", -9, 0, 0, 0, 0, -9, 0, -18
"c:\Users\rfrjo\pothole-detection-website\.next\static\webpack\webpack.536a639bf7e5e9f4.hot-update.js", "JavaScript", -9, 0, 0, 0, 0, -9, 0, -18
"c:\Users\rfrjo\pothole-detection-website\.next\static\webpack\webpack.53e51f86ef56df26.hot-update.js", "JavaScript", -9, 0, 0, 0, 0, -9, 0, -18
"c:\Users\rfrjo\pothole-detection-website\.next\static\webpack\webpack.54f6af229006dffa.hot-update.js", "JavaScript", -9, 0, 0, 0, 0, -9, 0, -18
"c:\Users\rfrjo\pothole-detection-website\.next\static\webpack\webpack.55c1de0576594fd6.hot-update.js", "JavaScript", -9, 0, 0, 0, 0, -9, 0, -18
"c:\Users\rfrjo\pothole-detection-website\.next\static\webpack\webpack.568a68dbfa67aef9.hot-update.js", "JavaScript", -9, 0, 0, 0, 0, -9, 0, -18
"c:\Users\rfrjo\pothole-detection-website\.next\static\webpack\webpack.599be672b367805b.hot-update.js", "JavaScript", 9, 0, 0, 0, 0, 9, 0, 18
"c:\Users\rfrjo\pothole-detection-website\.next\static\webpack\webpack.59bfc2d9eba83495.hot-update.js", "JavaScript", -9, 0, 0, 0, 0, -9, 0, -18
"c:\Users\rfrjo\pothole-detection-website\.next\static\webpack\webpack.59f4dd90ac1f2a7b.hot-update.js", "JavaScript", -9, 0, 0, 0, 0, -9, 0, -18
"c:\Users\rfrjo\pothole-detection-website\.next\static\webpack\webpack.5a3d1bcfab1dc770.hot-update.js", "JavaScript", -9, 0, 0, 0, 0, -9, 0, -18
"c:\Users\rfrjo\pothole-detection-website\.next\static\webpack\webpack.5ab59c38990547bb.hot-update.js", "JavaScript", -9, 0, 0, 0, 0, -9, 0, -18
"c:\Users\rfrjo\pothole-detection-website\.next\static\webpack\webpack.5b9b8e077d5bcc30.hot-update.js", "JavaScript", -9, 0, 0, 0, 0, -9, 0, -18
"c:\Users\rfrjo\pothole-detection-website\.next\static\webpack\webpack.5bbc0606b035f308.hot-update.js", "JavaScript", -9, 0, 0, 0, 0, -9, 0, -18
"c:\Users\rfrjo\pothole-detection-website\.next\static\webpack\webpack.5c91122845ef46d4.hot-update.js", "JavaScript", -9, 0, 0, 0, 0, -9, 0, -18
"c:\Users\rfrjo\pothole-detection-website\.next\static\webpack\webpack.5cabda8068dd9499.hot-update.js", "JavaScript", -9, 0, 0, 0, 0, -9, 0, -18
"c:\Users\rfrjo\pothole-detection-website\.next\static\webpack\webpack.5cf37d63cfe8d600.hot-update.js", "JavaScript", 9, 0, 0, 0, 0, 9, 0, 18
"c:\Users\rfrjo\pothole-detection-website\.next\static\webpack\webpack.5ea620540924ee60.hot-update.js", "JavaScript", -9, 0, 0, 0, 0, -9, 0, -18
"c:\Users\rfrjo\pothole-detection-website\.next\static\webpack\webpack.5ff81fa1db133655.hot-update.js", "JavaScript", -9, 0, 0, 0, 0, -9, 0, -18
"c:\Users\rfrjo\pothole-detection-website\.next\static\webpack\webpack.60527942db46d9b8.hot-update.js", "JavaScript", -9, 0, 0, 0, 0, -9, 0, -18
"c:\Users\rfrjo\pothole-detection-website\.next\static\webpack\webpack.6088ea14f533caf0.hot-update.js", "JavaScript", -9, 0, 0, 0, 0, -9, 0, -18
"c:\Users\rfrjo\pothole-detection-website\.next\static\webpack\webpack.611d7ddaf6eaaea5.hot-update.js", "JavaScript", 9, 0, 0, 0, 0, 9, 0, 18
"c:\Users\rfrjo\pothole-detection-website\.next\static\webpack\webpack.629b8911cc520362.hot-update.js", "JavaScript", -9, 0, 0, 0, 0, -9, 0, -18
"c:\Users\rfrjo\pothole-detection-website\.next\static\webpack\webpack.63971713ced1858f.hot-update.js", "JavaScript", -9, 0, 0, 0, 0, -9, 0, -18
"c:\Users\rfrjo\pothole-detection-website\.next\static\webpack\webpack.64ce06dd8784dad5.hot-update.js", "JavaScript", 9, 0, 0, 0, 0, 9, 0, 18
"c:\Users\rfrjo\pothole-detection-website\.next\static\webpack\webpack.6526ad0581466889.hot-update.js", "JavaScript", -9, 0, 0, 0, 0, -9, 0, -18
"c:\Users\rfrjo\pothole-detection-website\.next\static\webpack\webpack.6542ad685ec8b80d.hot-update.js", "JavaScript", -9, 0, 0, 0, 0, -9, 0, -18
"c:\Users\rfrjo\pothole-detection-website\.next\static\webpack\webpack.66d5ebd90917e4be.hot-update.js", "JavaScript", -9, 0, 0, 0, 0, -9, 0, -18
"c:\Users\rfrjo\pothole-detection-website\.next\static\webpack\webpack.6b3302e462d47832.hot-update.js", "JavaScript", 9, 0, 0, 0, 0, 9, 0, 18
"c:\Users\rfrjo\pothole-detection-website\.next\static\webpack\webpack.6c4c64dd3db346a4.hot-update.js", "JavaScript", -9, 0, 0, 0, 0, -9, 0, -18
"c:\Users\rfrjo\pothole-detection-website\.next\static\webpack\webpack.6e00b59ed9168a3b.hot-update.js", "JavaScript", -9, 0, 0, 0, 0, -9, 0, -18
"c:\Users\rfrjo\pothole-detection-website\.next\static\webpack\webpack.6e17eea08daa4461.hot-update.js", "JavaScript", 9, 0, 0, 0, 0, 9, 0, 18
"c:\Users\rfrjo\pothole-detection-website\.next\static\webpack\webpack.6f49d563ee97279e.hot-update.js", "JavaScript", -9, 0, 0, 0, 0, -9, 0, -18
"c:\Users\rfrjo\pothole-detection-website\.next\static\webpack\webpack.6f4e069acbdb7f44.hot-update.js", "JavaScript", -9, 0, 0, 0, 0, -9, 0, -18
"c:\Users\rfrjo\pothole-detection-website\.next\static\webpack\webpack.704ada73f32ffcfe.hot-update.js", "JavaScript", 9, 0, 0, 0, 0, 9, 0, 18
"c:\Users\rfrjo\pothole-detection-website\.next\static\webpack\webpack.705b809a0da72e0a.hot-update.js", "JavaScript", -9, 0, 0, 0, 0, -9, 0, -18
"c:\Users\rfrjo\pothole-detection-website\.next\static\webpack\webpack.7117d69c4d8dd1f0.hot-update.js", "JavaScript", -9, 0, 0, 0, 0, -9, 0, -18
"c:\Users\rfrjo\pothole-detection-website\.next\static\webpack\webpack.718317dae5cd0fbb.hot-update.js", "JavaScript", -9, 0, 0, 0, 0, -9, 0, -18
"c:\Users\rfrjo\pothole-detection-website\.next\static\webpack\webpack.71b4169a9c09d80b.hot-update.js", "JavaScript", -9, 0, 0, 0, 0, -9, 0, -18
"c:\Users\rfrjo\pothole-detection-website\.next\static\webpack\webpack.72539884909e2f51.hot-update.js", "JavaScript", -9, 0, 0, 0, 0, -9, 0, -18
"c:\Users\rfrjo\pothole-detection-website\.next\static\webpack\webpack.72e8be227edd0633.hot-update.js", "JavaScript", 9, 0, 0, 0, 0, 9, 0, 18
"c:\Users\rfrjo\pothole-detection-website\.next\static\webpack\webpack.74bf66b145b7f31a.hot-update.js", "JavaScript", 9, 0, 0, 0, 0, 9, 0, 18
"c:\Users\rfrjo\pothole-detection-website\.next\static\webpack\webpack.7553387ad1cc69a3.hot-update.js", "JavaScript", 9, 0, 0, 0, 0, 9, 0, 18
"c:\Users\rfrjo\pothole-detection-website\.next\static\webpack\webpack.76d95935b394a037.hot-update.js", "JavaScript", -9, 0, 0, 0, 0, -9, 0, -18
"c:\Users\rfrjo\pothole-detection-website\.next\static\webpack\webpack.771791e9f93ad77e.hot-update.js", "JavaScript", -9, 0, 0, 0, 0, -9, 0, -18
"c:\Users\rfrjo\pothole-detection-website\.next\static\webpack\webpack.7724e64c228ec499.hot-update.js", "JavaScript", -9, 0, 0, 0, 0, -9, 0, -18
"c:\Users\rfrjo\pothole-detection-website\.next\static\webpack\webpack.788ddaeb2bb2bb7b.hot-update.js", "JavaScript", -9, 0, 0, 0, 0, -9, 0, -18
"c:\Users\rfrjo\pothole-detection-website\.next\static\webpack\webpack.78b9918761b7ec60.hot-update.js", "JavaScript", -9, 0, 0, 0, 0, -9, 0, -18
"c:\Users\rfrjo\pothole-detection-website\.next\static\webpack\webpack.7c100b06603ce490.hot-update.js", "JavaScript", -9, 0, 0, 0, 0, -9, 0, -18
"c:\Users\rfrjo\pothole-detection-website\.next\static\webpack\webpack.7c3c6c0fb7269248.hot-update.js", "JavaScript", -9, 0, 0, 0, 0, -9, 0, -18
"c:\Users\rfrjo\pothole-detection-website\.next\static\webpack\webpack.7e20b43409008cc0.hot-update.js", "JavaScript", -9, 0, 0, 0, 0, -9, 0, -18
"c:\Users\rfrjo\pothole-detection-website\.next\static\webpack\webpack.80818ec3b62912ab.hot-update.js", "JavaScript", -9, 0, 0, 0, 0, -9, 0, -18
"c:\Users\rfrjo\pothole-detection-website\.next\static\webpack\webpack.813daabf623bf7ff.hot-update.js", "JavaScript", 9, 0, 0, 0, 0, 9, 0, 18
"c:\Users\rfrjo\pothole-detection-website\.next\static\webpack\webpack.82bcae466be0d753.hot-update.js", "JavaScript", 9, 0, 0, 0, 0, 9, 0, 18
"c:\Users\rfrjo\pothole-detection-website\.next\static\webpack\webpack.830fc07e3aa56e50.hot-update.js", "JavaScript", -9, 0, 0, 0, 0, -9, 0, -18
"c:\Users\rfrjo\pothole-detection-website\.next\static\webpack\webpack.836403eb24b7ffbd.hot-update.js", "JavaScript", -9, 0, 0, 0, 0, -9, 0, -18
"c:\Users\rfrjo\pothole-detection-website\.next\static\webpack\webpack.84b6aaa9e7aab2e2.hot-update.js", "JavaScript", -9, 0, 0, 0, 0, -9, 0, -18
"c:\Users\rfrjo\pothole-detection-website\.next\static\webpack\webpack.854534e54fe1e890.hot-update.js", "JavaScript", -9, 0, 0, 0, 0, -9, 0, -18
"c:\Users\rfrjo\pothole-detection-website\.next\static\webpack\webpack.863a15ead088bba9.hot-update.js", "JavaScript", -9, 0, 0, 0, 0, -9, 0, -18
"c:\Users\rfrjo\pothole-detection-website\.next\static\webpack\webpack.87eae4974001cebd.hot-update.js", "JavaScript", -9, 0, 0, 0, 0, -9, 0, -18
"c:\Users\rfrjo\pothole-detection-website\.next\static\webpack\webpack.8894e59acb5af99a.hot-update.js", "JavaScript", -9, 0, 0, 0, 0, -9, 0, -18
"c:\Users\rfrjo\pothole-detection-website\.next\static\webpack\webpack.89bd7cc19491664a.hot-update.js", "JavaScript", -9, 0, 0, 0, 0, -9, 0, -18
"c:\Users\rfrjo\pothole-detection-website\.next\static\webpack\webpack.89bf9314c5143b75.hot-update.js", "JavaScript", -9, 0, 0, 0, 0, -9, 0, -18
"c:\Users\rfrjo\pothole-detection-website\.next\static\webpack\webpack.8ce78540ee6b936c.hot-update.js", "JavaScript", 9, 0, 0, 0, 0, 9, 0, 18
"c:\Users\rfrjo\pothole-detection-website\.next\static\webpack\webpack.8cfc7e3849acd858.hot-update.js", "JavaScript", -9, 0, 0, 0, 0, -9, 0, -18
"c:\Users\rfrjo\pothole-detection-website\.next\static\webpack\webpack.8d1022a00db06c96.hot-update.js", "JavaScript", 9, 0, 0, 0, 0, 9, 0, 18
"c:\Users\rfrjo\pothole-detection-website\.next\static\webpack\webpack.8fd824ed7d27ab5d.hot-update.js", "JavaScript", -9, 0, 0, 0, 0, -9, 0, -18
"c:\Users\rfrjo\pothole-detection-website\.next\static\webpack\webpack.90045a25807a574e.hot-update.js", "JavaScript", -9, 0, 0, 0, 0, -9, 0, -18
"c:\Users\rfrjo\pothole-detection-website\.next\static\webpack\webpack.90600ccfb467a9cb.hot-update.js", "JavaScript", 9, 0, 0, 0, 0, 9, 0, 18
"c:\Users\rfrjo\pothole-detection-website\.next\static\webpack\webpack.9066f5ce9def0675.hot-update.js", "JavaScript", -9, 0, 0, 0, 0, -9, 0, -18
"c:\Users\rfrjo\pothole-detection-website\.next\static\webpack\webpack.92d17d5f338d6d65.hot-update.js", "JavaScript", 9, 0, 0, 0, 0, 9, 0, 18
"c:\Users\rfrjo\pothole-detection-website\.next\static\webpack\webpack.930cbca6693a54f4.hot-update.js", "JavaScript", -9, 0, 0, 0, 0, -9, 0, -18
"c:\Users\rfrjo\pothole-detection-website\.next\static\webpack\webpack.93cccf4e68c8f5fa.hot-update.js", "JavaScript", 9, 0, 0, 0, 0, 9, 0, 18
"c:\Users\rfrjo\pothole-detection-website\.next\static\webpack\webpack.94327a28070e9b59.hot-update.js", "JavaScript", 9, 0, 0, 0, 0, 9, 0, 18
"c:\Users\rfrjo\pothole-detection-website\.next\static\webpack\webpack.9494dc6d0ed8da0d.hot-update.js", "JavaScript", -9, 0, 0, 0, 0, -9, 0, -18
"c:\Users\rfrjo\pothole-detection-website\.next\static\webpack\webpack.949edd130e0d8b15.hot-update.js", "JavaScript", 9, 0, 0, 0, 0, 9, 0, 18
"c:\Users\rfrjo\pothole-detection-website\.next\static\webpack\webpack.9569517952febcf7.hot-update.js", "JavaScript", -9, 0, 0, 0, 0, -9, 0, -18
"c:\Users\rfrjo\pothole-detection-website\.next\static\webpack\webpack.9664f6c3a3baf5cb.hot-update.js", "JavaScript", -9, 0, 0, 0, 0, -9, 0, -18
"c:\Users\rfrjo\pothole-detection-website\.next\static\webpack\webpack.96ee604f28de5976.hot-update.js", "JavaScript", 9, 0, 0, 0, 0, 9, 0, 18
"c:\Users\rfrjo\pothole-detection-website\.next\static\webpack\webpack.972e47f8fdb1b92a.hot-update.js", "JavaScript", -9, 0, 0, 0, 0, -9, 0, -18
"c:\Users\rfrjo\pothole-detection-website\.next\static\webpack\webpack.988bbacd3bd4b4ed.hot-update.js", "JavaScript", -9, 0, 0, 0, 0, -9, 0, -18
"c:\Users\rfrjo\pothole-detection-website\.next\static\webpack\webpack.98a6d50291545cbd.hot-update.js", "JavaScript", -9, 0, 0, 0, 0, -9, 0, -18
"c:\Users\rfrjo\pothole-detection-website\.next\static\webpack\webpack.98f069abc21157d7.hot-update.js", "JavaScript", -9, 0, 0, 0, 0, -9, 0, -18
"c:\Users\rfrjo\pothole-detection-website\.next\static\webpack\webpack.994fc480f771c087.hot-update.js", "JavaScript", -9, 0, 0, 0, 0, -9, 0, -18
"c:\Users\rfrjo\pothole-detection-website\.next\static\webpack\webpack.99759e6ba0f88485.hot-update.js", "JavaScript", -9, 0, 0, 0, 0, -9, 0, -18
"c:\Users\rfrjo\pothole-detection-website\.next\static\webpack\webpack.998bbd00e52b9ad6.hot-update.js", "JavaScript", 9, 0, 0, 0, 0, 9, 0, 18
"c:\Users\rfrjo\pothole-detection-website\.next\static\webpack\webpack.9a3cb0f6c67b7b74.hot-update.js", "JavaScript", 9, 0, 0, 0, 0, 9, 0, 18
"c:\Users\rfrjo\pothole-detection-website\.next\static\webpack\webpack.9a469bb35965f49b.hot-update.js", "JavaScript", 9, 0, 0, 0, 0, 9, 0, 18
"c:\Users\rfrjo\pothole-detection-website\.next\static\webpack\webpack.9a9a2294c755eeb5.hot-update.js", "JavaScript", -9, 0, 0, 0, 0, -9, 0, -18
"c:\Users\rfrjo\pothole-detection-website\.next\static\webpack\webpack.9ab20fa73369eec1.hot-update.js", "JavaScript", -9, 0, 0, 0, 0, -9, 0, -18
"c:\Users\rfrjo\pothole-detection-website\.next\static\webpack\webpack.9ab9d809f1c15a7c.hot-update.js", "JavaScript", -9, 0, 0, 0, 0, -9, 0, -18
"c:\Users\rfrjo\pothole-detection-website\.next\static\webpack\webpack.9ad0b9331bbdf1ef.hot-update.js", "JavaScript", -9, 0, 0, 0, 0, -9, 0, -18
"c:\Users\rfrjo\pothole-detection-website\.next\static\webpack\webpack.9b177a6343dedfa5.hot-update.js", "JavaScript", 9, 0, 0, 0, 0, 9, 0, 18
"c:\Users\rfrjo\pothole-detection-website\.next\static\webpack\webpack.9b7dfac18cc1ecab.hot-update.js", "JavaScript", 9, 0, 0, 0, 0, 9, 0, 18
"c:\Users\rfrjo\pothole-detection-website\.next\static\webpack\webpack.9da82ad33978809b.hot-update.js", "JavaScript", -9, 0, 0, 0, 0, -9, 0, -18
"c:\Users\rfrjo\pothole-detection-website\.next\static\webpack\webpack.a2a68842df227705.hot-update.js", "JavaScript", -9, 0, 0, 0, 0, -9, 0, -18
"c:\Users\rfrjo\pothole-detection-website\.next\static\webpack\webpack.a63f32a84bd50758.hot-update.js", "JavaScript", -9, 0, 0, 0, 0, -9, 0, -18
"c:\Users\rfrjo\pothole-detection-website\.next\static\webpack\webpack.a6871c336bb962c8.hot-update.js", "JavaScript", -9, 0, 0, 0, 0, -9, 0, -18
"c:\Users\rfrjo\pothole-detection-website\.next\static\webpack\webpack.a6b97f6905db5af0.hot-update.js", "JavaScript", -9, 0, 0, 0, 0, -9, 0, -18
"c:\Users\rfrjo\pothole-detection-website\.next\static\webpack\webpack.a6f20656ebead5cb.hot-update.js", "JavaScript", -9, 0, 0, 0, 0, -9, 0, -18
"c:\Users\rfrjo\pothole-detection-website\.next\static\webpack\webpack.a7c0b93360be3965.hot-update.js", "JavaScript", -9, 0, 0, 0, 0, -9, 0, -18
"c:\Users\rfrjo\pothole-detection-website\.next\static\webpack\webpack.a83439c9a62dd260.hot-update.js", "JavaScript", -9, 0, 0, 0, 0, -9, 0, -18
"c:\Users\rfrjo\pothole-detection-website\.next\static\webpack\webpack.a88718d08d250638.hot-update.js", "JavaScript", 9, 0, 0, 0, 0, 9, 0, 18
"c:\Users\rfrjo\pothole-detection-website\.next\static\webpack\webpack.a926cb6e29706adb.hot-update.js", "JavaScript", -9, 0, 0, 0, 0, -9, 0, -18
"c:\Users\rfrjo\pothole-detection-website\.next\static\webpack\webpack.a9862d632b38a6ac.hot-update.js", "JavaScript", -9, 0, 0, 0, 0, -9, 0, -18
"c:\Users\rfrjo\pothole-detection-website\.next\static\webpack\webpack.aaf213d626cf9eed.hot-update.js", "JavaScript", -9, 0, 0, 0, 0, -9, 0, -18
"c:\Users\rfrjo\pothole-detection-website\.next\static\webpack\webpack.ac63d61331c9c256.hot-update.js", "JavaScript", -9, 0, 0, 0, 0, -9, 0, -18
"c:\Users\rfrjo\pothole-detection-website\.next\static\webpack\webpack.acceac5bfdb54fd8.hot-update.js", "JavaScript", 9, 0, 0, 0, 0, 9, 0, 18
"c:\Users\rfrjo\pothole-detection-website\.next\static\webpack\webpack.ae005569fba7523e.hot-update.js", "JavaScript", -9, 0, 0, 0, 0, -9, 0, -18
"c:\Users\rfrjo\pothole-detection-website\.next\static\webpack\webpack.af4f58f2e564eb2c.hot-update.js", "JavaScript", -9, 0, 0, 0, 0, -9, 0, -18
"c:\Users\rfrjo\pothole-detection-website\.next\static\webpack\webpack.afe8b402b606adb8.hot-update.js", "JavaScript", -9, 0, 0, 0, 0, -9, 0, -18
"c:\Users\rfrjo\pothole-detection-website\.next\static\webpack\webpack.b00e9254685beba5.hot-update.js", "JavaScript", -9, 0, 0, 0, 0, -9, 0, -18
"c:\Users\rfrjo\pothole-detection-website\.next\static\webpack\webpack.b202d06b191d5f76.hot-update.js", "JavaScript", -9, 0, 0, 0, 0, -9, 0, -18
"c:\Users\rfrjo\pothole-detection-website\.next\static\webpack\webpack.b33251ce981b4e64.hot-update.js", "JavaScript", -9, 0, 0, 0, 0, -9, 0, -18
"c:\Users\rfrjo\pothole-detection-website\.next\static\webpack\webpack.b356f9349f46c05f.hot-update.js", "JavaScript", -9, 0, 0, 0, 0, -9, 0, -18
"c:\Users\rfrjo\pothole-detection-website\.next\static\webpack\webpack.b4935ee67ccb232c.hot-update.js", "JavaScript", 9, 0, 0, 0, 0, 9, 0, 18
"c:\Users\rfrjo\pothole-detection-website\.next\static\webpack\webpack.b58f405b4f945bc5.hot-update.js", "JavaScript", -9, 0, 0, 0, 0, -9, 0, -18
"c:\Users\rfrjo\pothole-detection-website\.next\static\webpack\webpack.b6fccb5d616f7190.hot-update.js", "JavaScript", -9, 0, 0, 0, 0, -9, 0, -18
"c:\Users\rfrjo\pothole-detection-website\.next\static\webpack\webpack.b724e9efc9d6f974.hot-update.js", "JavaScript", -9, 0, 0, 0, 0, -9, 0, -18
"c:\Users\rfrjo\pothole-detection-website\.next\static\webpack\webpack.b9b6070c1ac65dfc.hot-update.js", "JavaScript", -9, 0, 0, 0, 0, -9, 0, -18
"c:\Users\rfrjo\pothole-detection-website\.next\static\webpack\webpack.ba3c414df75c4b96.hot-update.js", "JavaScript", -9, 0, 0, 0, 0, -9, 0, -18
"c:\Users\rfrjo\pothole-detection-website\.next\static\webpack\webpack.bd975f57d9c1d99b.hot-update.js", "JavaScript", -9, 0, 0, 0, 0, -9, 0, -18
"c:\Users\rfrjo\pothole-detection-website\.next\static\webpack\webpack.be3da15174200697.hot-update.js", "JavaScript", 9, 0, 0, 0, 0, 9, 0, 18
"c:\Users\rfrjo\pothole-detection-website\.next\static\webpack\webpack.be3e42fe055d75c9.hot-update.js", "JavaScript", 9, 0, 0, 0, 0, 9, 0, 18
"c:\Users\rfrjo\pothole-detection-website\.next\static\webpack\webpack.c174dae197df82fa.hot-update.js", "JavaScript", 9, 0, 0, 0, 0, 9, 0, 18
"c:\Users\rfrjo\pothole-detection-website\.next\static\webpack\webpack.c198d3adce0d1177.hot-update.js", "JavaScript", -9, 0, 0, 0, 0, -9, 0, -18
"c:\Users\rfrjo\pothole-detection-website\.next\static\webpack\webpack.c2f90dd08b817d3a.hot-update.js", "JavaScript", -9, 0, 0, 0, 0, -9, 0, -18
"c:\Users\rfrjo\pothole-detection-website\.next\static\webpack\webpack.c4ba3707ef3455b0.hot-update.js", "JavaScript", 9, 0, 0, 0, 0, 9, 0, 18
"c:\Users\rfrjo\pothole-detection-website\.next\static\webpack\webpack.c51eb2b4dce68746.hot-update.js", "JavaScript", -9, 0, 0, 0, 0, -9, 0, -18
"c:\Users\rfrjo\pothole-detection-website\.next\static\webpack\webpack.c79ca73a382824b7.hot-update.js", "JavaScript", -9, 0, 0, 0, 0, -9, 0, -18
"c:\Users\rfrjo\pothole-detection-website\.next\static\webpack\webpack.c7ebeba584f48140.hot-update.js", "JavaScript", -9, 0, 0, 0, 0, -9, 0, -18
"c:\Users\rfrjo\pothole-detection-website\.next\static\webpack\webpack.c863c433a47baf3d.hot-update.js", "JavaScript", 9, 0, 0, 0, 0, 9, 0, 18
"c:\Users\rfrjo\pothole-detection-website\.next\static\webpack\webpack.ca06906c618b58c0.hot-update.js", "JavaScript", -9, 0, 0, 0, 0, -9, 0, -18
"c:\Users\rfrjo\pothole-detection-website\.next\static\webpack\webpack.ca98b2f35be87c40.hot-update.js", "JavaScript", -9, 0, 0, 0, 0, -9, 0, -18
"c:\Users\rfrjo\pothole-detection-website\.next\static\webpack\webpack.cc78697ad538e48d.hot-update.js", "JavaScript", -9, 0, 0, 0, 0, -9, 0, -18
"c:\Users\rfrjo\pothole-detection-website\.next\static\webpack\webpack.cc804bd8b794cc35.hot-update.js", "JavaScript", -9, 0, 0, 0, 0, -9, 0, -18
"c:\Users\rfrjo\pothole-detection-website\.next\static\webpack\webpack.cc9db873835968af.hot-update.js", "JavaScript", -9, 0, 0, 0, 0, -9, 0, -18
"c:\Users\rfrjo\pothole-detection-website\.next\static\webpack\webpack.cd33e8b75fd3d567.hot-update.js", "JavaScript", 9, 0, 0, 0, 0, 9, 0, 18
"c:\Users\rfrjo\pothole-detection-website\.next\static\webpack\webpack.cd3728e5463e40ac.hot-update.js", "JavaScript", 9, 0, 0, 0, 0, 9, 0, 18
"c:\Users\rfrjo\pothole-detection-website\.next\static\webpack\webpack.cd89fb3069b50aab.hot-update.js", "JavaScript", -9, 0, 0, 0, 0, -9, 0, -18
"c:\Users\rfrjo\pothole-detection-website\.next\static\webpack\webpack.cd8b500c9d524f82.hot-update.js", "JavaScript", -9, 0, 0, 0, 0, -9, 0, -18
"c:\Users\rfrjo\pothole-detection-website\.next\static\webpack\webpack.cddbb80b4fa7f701.hot-update.js", "JavaScript", -9, 0, 0, 0, 0, -9, 0, -18
"c:\Users\rfrjo\pothole-detection-website\.next\static\webpack\webpack.cf1be1f66aaef90c.hot-update.js", "JavaScript", 13, 0, 0, 0, 0, 10, 0, 23
"c:\Users\rfrjo\pothole-detection-website\.next\static\webpack\webpack.cf5421d78a074520.hot-update.js", "JavaScript", -9, 0, 0, 0, 0, -9, 0, -18
"c:\Users\rfrjo\pothole-detection-website\.next\static\webpack\webpack.cfb96863d6bdef00.hot-update.js", "JavaScript", 9, 0, 0, 0, 0, 9, 0, 18
"c:\Users\rfrjo\pothole-detection-website\.next\static\webpack\webpack.d0e21abc3f17e927.hot-update.js", "JavaScript", -9, 0, 0, 0, 0, -9, 0, -18
"c:\Users\rfrjo\pothole-detection-website\.next\static\webpack\webpack.d26a62214cbd792d.hot-update.js", "JavaScript", -9, 0, 0, 0, 0, -9, 0, -18
"c:\Users\rfrjo\pothole-detection-website\.next\static\webpack\webpack.d2b39e3fbc806218.hot-update.js", "JavaScript", 9, 0, 0, 0, 0, 9, 0, 18
"c:\Users\rfrjo\pothole-detection-website\.next\static\webpack\webpack.d35bcc164f83e081.hot-update.js", "JavaScript", -9, 0, 0, 0, 0, -9, 0, -18
"c:\Users\rfrjo\pothole-detection-website\.next\static\webpack\webpack.d3f9d5d6accb4bbb.hot-update.js", "JavaScript", 9, 0, 0, 0, 0, 9, 0, 18
"c:\Users\rfrjo\pothole-detection-website\.next\static\webpack\webpack.d46b0477114cd521.hot-update.js", "JavaScript", -9, 0, 0, 0, 0, -9, 0, -18
"c:\Users\rfrjo\pothole-detection-website\.next\static\webpack\webpack.d4cfa901868645e2.hot-update.js", "JavaScript", 9, 0, 0, 0, 0, 9, 0, 18
"c:\Users\rfrjo\pothole-detection-website\.next\static\webpack\webpack.d7f4b3c0f1019bfb.hot-update.js", "JavaScript", -9, 0, 0, 0, 0, -9, 0, -18
"c:\Users\rfrjo\pothole-detection-website\.next\static\webpack\webpack.d811744dbedd33fe.hot-update.js", "JavaScript", -9, 0, 0, 0, 0, -9, 0, -18
"c:\Users\rfrjo\pothole-detection-website\.next\static\webpack\webpack.d8b408ff1213441e.hot-update.js", "JavaScript", 9, 0, 0, 0, 0, 9, 0, 18
"c:\Users\rfrjo\pothole-detection-website\.next\static\webpack\webpack.d9a2c09833ac5b84.hot-update.js", "JavaScript", -9, 0, 0, 0, 0, -9, 0, -18
"c:\Users\rfrjo\pothole-detection-website\.next\static\webpack\webpack.d9d9e8eb36e4a319.hot-update.js", "JavaScript", -9, 0, 0, 0, 0, -9, 0, -18
"c:\Users\rfrjo\pothole-detection-website\.next\static\webpack\webpack.da189dca28b2fd71.hot-update.js", "JavaScript", -9, 0, 0, 0, 0, -9, 0, -18
"c:\Users\rfrjo\pothole-detection-website\.next\static\webpack\webpack.da6ee9ed3accfd7c.hot-update.js", "JavaScript", -9, 0, 0, 0, 0, -9, 0, -18
"c:\Users\rfrjo\pothole-detection-website\.next\static\webpack\webpack.dc9aabb6db3bc5e2.hot-update.js", "JavaScript", -9, 0, 0, 0, 0, -9, 0, -18
"c:\Users\rfrjo\pothole-detection-website\.next\static\webpack\webpack.dd156bdb1fdaed17.hot-update.js", "JavaScript", -9, 0, 0, 0, 0, -9, 0, -18
"c:\Users\rfrjo\pothole-detection-website\.next\static\webpack\webpack.df6583e3b6affbbb.hot-update.js", "JavaScript", 9, 0, 0, 0, 0, 9, 0, 18
"c:\Users\rfrjo\pothole-detection-website\.next\static\webpack\webpack.e0aa062d3cdf4a32.hot-update.js", "JavaScript", -9, 0, 0, 0, 0, -9, 0, -18
"c:\Users\rfrjo\pothole-detection-website\.next\static\webpack\webpack.e0e9443637d32cb1.hot-update.js", "JavaScript", -9, 0, 0, 0, 0, -9, 0, -18
"c:\Users\rfrjo\pothole-detection-website\.next\static\webpack\webpack.e10874c4bc226ea0.hot-update.js", "JavaScript", -9, 0, 0, 0, 0, -9, 0, -18
"c:\Users\rfrjo\pothole-detection-website\.next\static\webpack\webpack.e3ff949e143f65d2.hot-update.js", "JavaScript", -9, 0, 0, 0, 0, -9, 0, -18
"c:\Users\rfrjo\pothole-detection-website\.next\static\webpack\webpack.e8591e517137c060.hot-update.js", "JavaScript", -9, 0, 0, 0, 0, -9, 0, -18
"c:\Users\rfrjo\pothole-detection-website\.next\static\webpack\webpack.e8b3f5af01348270.hot-update.js", "JavaScript", 9, 0, 0, 0, 0, 9, 0, 18
"c:\Users\rfrjo\pothole-detection-website\.next\static\webpack\webpack.e90067ef8ce6181d.hot-update.js", "JavaScript", -9, 0, 0, 0, 0, -9, 0, -18
"c:\Users\rfrjo\pothole-detection-website\.next\static\webpack\webpack.e94531ca0dfc0721.hot-update.js", "JavaScript", -9, 0, 0, 0, 0, -9, 0, -18
"c:\Users\rfrjo\pothole-detection-website\.next\static\webpack\webpack.eafe582f0f415f2e.hot-update.js", "JavaScript", -9, 0, 0, 0, 0, -9, 0, -18
"c:\Users\rfrjo\pothole-detection-website\.next\static\webpack\webpack.eb31eec642aac43d.hot-update.js", "JavaScript", -9, 0, 0, 0, 0, -9, 0, -18
"c:\Users\rfrjo\pothole-detection-website\.next\static\webpack\webpack.eb6c58442bbef117.hot-update.js", "JavaScript", -9, 0, 0, 0, 0, -9, 0, -18
"c:\Users\rfrjo\pothole-detection-website\.next\static\webpack\webpack.ee0348281aac2ba8.hot-update.js", "JavaScript", -9, 0, 0, 0, 0, -9, 0, -18
"c:\Users\rfrjo\pothole-detection-website\.next\static\webpack\webpack.eea850992acc70bf.hot-update.js", "JavaScript", -9, 0, 0, 0, 0, -9, 0, -18
"c:\Users\rfrjo\pothole-detection-website\.next\static\webpack\webpack.eec024fae8f4e249.hot-update.js", "JavaScript", -9, 0, 0, 0, 0, -9, 0, -18
"c:\Users\rfrjo\pothole-detection-website\.next\static\webpack\webpack.ef06e8bcc4d5cc20.hot-update.js", "JavaScript", -9, 0, 0, 0, 0, -9, 0, -18
"c:\Users\rfrjo\pothole-detection-website\.next\static\webpack\webpack.f00f7e380c8004ef.hot-update.js", "JavaScript", 9, 0, 0, 0, 0, 9, 0, 18
"c:\Users\rfrjo\pothole-detection-website\.next\static\webpack\webpack.f08265c37c969fb9.hot-update.js", "JavaScript", -9, 0, 0, 0, 0, -9, 0, -18
"c:\Users\rfrjo\pothole-detection-website\.next\static\webpack\webpack.f2792f19a4cb8f1e.hot-update.js", "JavaScript", -9, 0, 0, 0, 0, -9, 0, -18
"c:\Users\rfrjo\pothole-detection-website\.next\static\webpack\webpack.f2a913967631bb19.hot-update.js", "JavaScript", -9, 0, 0, 0, 0, -9, 0, -18
"c:\Users\rfrjo\pothole-detection-website\.next\static\webpack\webpack.f3323091d852bbdc.hot-update.js", "JavaScript", -9, 0, 0, 0, 0, -9, 0, -18
"c:\Users\rfrjo\pothole-detection-website\.next\static\webpack\webpack.f33d64cb0afa3b86.hot-update.js", "JavaScript", -9, 0, 0, 0, 0, -9, 0, -18
"c:\Users\rfrjo\pothole-detection-website\.next\static\webpack\webpack.f3561c083243df06.hot-update.js", "JavaScript", -9, 0, 0, 0, 0, -9, 0, -18
"c:\Users\rfrjo\pothole-detection-website\.next\static\webpack\webpack.f47b825168d22aa0.hot-update.js", "JavaScript", -9, 0, 0, 0, 0, -9, 0, -18
"c:\Users\rfrjo\pothole-detection-website\.next\static\webpack\webpack.f47de2872720f503.hot-update.js", "JavaScript", -9, 0, 0, 0, 0, -9, 0, -18
"c:\Users\rfrjo\pothole-detection-website\.next\static\webpack\webpack.f51ef73fe7ab9246.hot-update.js", "JavaScript", 9, 0, 0, 0, 0, 9, 0, 18
"c:\Users\rfrjo\pothole-detection-website\.next\static\webpack\webpack.f71e8e55740cd286.hot-update.js", "JavaScript", 9, 0, 0, 0, 0, 9, 0, 18
"c:\Users\rfrjo\pothole-detection-website\.next\static\webpack\webpack.f88d041dae8d9828.hot-update.js", "JavaScript", 9, 0, 0, 0, 0, 9, 0, 18
"c:\Users\rfrjo\pothole-detection-website\.next\static\webpack\webpack.f9520265e142ad5e.hot-update.js", "JavaScript", -9, 0, 0, 0, 0, -9, 0, -18
"c:\Users\rfrjo\pothole-detection-website\.next\static\webpack\webpack.f9c5fb343c296e1c.hot-update.js", "JavaScript", 9, 0, 0, 0, 0, 9, 0, 18
"c:\Users\rfrjo\pothole-detection-website\.next\static\webpack\webpack.f9de1ca68fbbf2ec.hot-update.js", "JavaScript", 9, 0, 0, 0, 0, 9, 0, 18
"c:\Users\rfrjo\pothole-detection-website\.next\static\webpack\webpack.fa7fd5fadcff3ac4.hot-update.js", "JavaScript", -9, 0, 0, 0, 0, -9, 0, -18
"c:\Users\rfrjo\pothole-detection-website\.next\static\webpack\webpack.fb7ae82af7c3ab0d.hot-update.js", "JavaScript", 9, 0, 0, 0, 0, 9, 0, 18
"c:\Users\rfrjo\pothole-detection-website\.next\static\webpack\webpack.fbe4fd7e0754fbdb.hot-update.js", "JavaScript", -9, 0, 0, 0, 0, -9, 0, -18
"c:\Users\rfrjo\pothole-detection-website\.next\static\webpack\webpack.fbe925cde8eeb7dc.hot-update.js", "JavaScript", -9, 0, 0, 0, 0, -9, 0, -18
"c:\Users\rfrjo\pothole-detection-website\.next\static\webpack\webpack.fc51d71f73067d3f.hot-update.js", "JavaScript", -9, 0, 0, 0, 0, -9, 0, -18
"c:\Users\rfrjo\pothole-detection-website\.next\static\webpack\webpack.fe049f32ee0f38ef.hot-update.js", "JavaScript", 9, 0, 0, 0, 0, 9, 0, 18
"c:\Users\rfrjo\pothole-detection-website\.next\static\webpack\webpack.fe18180edebcb09e.hot-update.js", "JavaScript", -9, 0, 0, 0, 0, -9, 0, -18
"c:\Users\rfrjo\pothole-detection-website\.next\static\webpack\webpack.ffb54dfc8e5706f9.hot-update.js", "JavaScript", -9, 0, 0, 0, 0, -9, 0, -18
"c:\Users\rfrjo\pothole-detection-website\.next\types\app\api\auth\[auth0]\route.ts", "TypeScript", 0, 0, 0, 0, -309, -14, -21, -344
"c:\Users\rfrjo\pothole-detection-website\.next\types\app\maps\page.ts", "TypeScript", 0, 0, 0, 0, -52, -10, -18, -80
"c:\Users\rfrjo\pothole-detection-website\.next\types\app\signup\page.ts", "TypeScript", 0, 0, 0, 0, -52, -10, -18, -80
"c:\Users\rfrjo\pothole-detection-website\app\api\upload\route.ts", "TypeScript", 0, 0, 0, 0, -17, -2, -3, -22
"c:\Users\rfrjo\pothole-detection-website\app\components\Sidebar.tsx", "TypeScript JSX", 0, 11, 0, 0, 0, 4, 2, 17
"c:\Users\rfrjo\pothole-detection-website\app\signup\page.tsx", "TypeScript JSX", 0, 1, 0, 0, 0, 0, 0, 1
"c:\Users\rfrjo\pothole-detection-website\app\spreadsheets\page.tsx", "TypeScript JSX", 0, 80, 0, 0, 0, 0, 4, 84
"c:\Users\rfrjo\pothole-detection-website\app\upload\page.tsx", "TypeScript JSX", 0, 220, 0, 0, 0, 10, 21, 251
"c:\Users\rfrjo\pothole-detection-website\components\FollowingSidebar.tsx", "TypeScript JSX", 0, 16, 0, 0, 0, 0, 0, 16
"c:\Users\rfrjo\pothole-detection-website\components\HomePage\Navbar.tsx", "TypeScript JSX", 0, 14, 0, 0, 0, 0, 1, 15
"c:\Users\rfrjo\pothole-detection-website\components\ui\dialog.tsx", "TypeScript JSX", 0, 111, 0, 0, 0, 0, 12, 123
"c:\Users\rfrjo\pothole-detection-website\components\ui\tabs.tsx", "TypeScript JSX", 0, 48, 0, 0, 0, 0, 7, 55
"c:\Users\rfrjo\pothole-detection-website\components\ui\toast.tsx", "TypeScript JSX", 0, 115, 0, 0, 0, 0, 12, 127
"c:\Users\rfrjo\pothole-detection-website\components\ui\use-toast.tsx", "TypeScript JSX", 0, 159, 0, 0, 0, 2, 30, 191
"c:\Users\rfrjo\pothole-detection-website\firebase.ts", "TypeScript", 0, 0, 0, 0, 2, 0, 0, 2
"c:\Users\rfrjo\pothole-detection-website\lib\db.ts", "TypeScript", 0, 0, 0, 0, -6, -2, -3, -11
"c:\Users\rfrjo\pothole-detection-website\package-lock.json", "JSON", 0, 0, 1674, 0, 0, 0, 0, 1674
"c:\Users\rfrjo\pothole-detection-website\package.json", "JSON", 0, 0, 5, 0, 0, 0, 0, 5
"c:\Users\rfrjo\pothole-detection-website\tailwind.config.js", "JavaScript", 4, 0, 0, 0, 0, 0, 0, 4
"Total", "-", -10116, 775, 1543, -33, -434, -9163, -4640, -22068